ORG_NAME	BHRRC_URL
Águas do Amazonas (part of Suez)	A/guasdoAmazonaspartofSuez
A S Watson	A/ASWatson
A&A Global Industries	A/AAGlobalIndustries
A&G Group	A/AGGroup
A.P. Moller - Maersk	A/APMoller-Maersk
AA	A/AA
Aarhus United	A/AarhusUnited
Abayak	A/Abayak
ABB	A/ABB
Abbey National	A/AbbeyNational
Abbott Laboratories	A/AbbottLaboratories
ABC (part of Walt Disney)	A/ABCpartofWaltDisney
ABC (Spain)	A/ABCSpain
Abelle	A/Abelle
Abengoa	A/Abengoa
Aber Diamond	A/AberDiamond
Abercrombie & Fitch	A/AbercrombieFitch
Abercrombie & Kent	A/AbercrombieKent
Aberdeen Asset Management	A/AberdeenAssetManagement
ABIL (see African Bank Investments Limited)	A/ABILseeAfricanBankInvestmentsLimited
Abitibi	A/Abitibi
ABM	A/ABM
ABN Amro	A/ABNAmro
Aboitiz	A/Aboitiz
Aborganicos	A/Aborganicos
Absa	A/Absa
ACADIA Pharmaceuticals	A/ACADIAPharmaceuticals
ACC Capital Holdings	A/ACCCapitalHoldings
ACC Limited (Associated Cement Companies)	A/ACCLimitedAssociatedCementCompanies
Accenture	A/Accenture
Acciona	A/Acciona
Accor	A/Accor
Accuron	A/Accuron
ACE Group	A/ACEGroup
Acer	A/Acer
Aché Laboratórios Farmacêuticos	A/AchLaboratriosFarmacuticos
Acindar	A/Acindar
Ackermans	A/Ackermans
Acordis	A/Acordis
Acordis Acetate (part of Acordis)	A/AcordisAcetatepartofAcordis
Acres International	A/AcresInternational
ACSA (Airports Company South Africa)	A/ACSAAirportsCompanySouthAfrica
Actelion	A/Actelion
Actis	A/Actis
Adam's Mark	A/AdamsMark
Adastra Minerals	A/AdastraMinerals
Adcock Ingram (part of Tiger Brands)	A/AdcockIngrampartofTigerBrands
Addleshaw Goddard	A/AddleshawGoddard
Adecco	A/Adecco
Adelca (Acería del Ecuador)	A/AdelcaAceradelEcuador
ADI Limited (joint venture Transfield Holdings & Thales)	A/ADILimitedjointventureTransfieldHoldingsThales
Adia	A/Adia
adidas	A/adidas
Aditya Birla Group	A/AdityaBirlaGroup
ADM (see Archer Daniels Midland)	A/ADMseeArcherDanielsMidland
Adnams	A/Adnams
Adobe Systems	A/AdobeSystems
Adolfo Domínguez	A/AdolfoDomnguez
Adolph Coors (part of Molson Coors)	A/AdolphCoorspartofMolsonCoors
ADP (see Aéroports de Paris)	A/ADPseeAroportsdeParis
Advance Publications	A/AdvancePublications
Advanced Bio-Extracts	A/AdvancedBio-Extracts
Advanced Micro Devices	A/AdvancedMicroDevices
Advanta	A/Advanta
Adventures Abroad	A/AdventuresAbroad
Aegis (see Aegis Defence Services)	A/AegisseeAegisDefenceServices
Aegis Defence Services	A/AegisDefenceServices
Aegon	A/Aegon
AEON	A/AEON
Aero Contractors	A/AeroContractors
Aerocom	A/Aerocom
Aerodespachos Colombia (Aercol)	A/AerodespachosColombiaAercol
Aerolíneas Argentinas	A/AerolneasArgentinas
Aeroméxico	A/Aeromxico
Aéroports de Paris (ADP)	A/AroportsdeParisADP
Aerospatiale Matra (part of EADS)	A/AerospatialeMatrapartofEADS
Aerowisata (part of Garuda Indonesia)	A/AerowisatapartofGarudaIndonesia
AES	A/AES
Aetna	A/Aetna
AFC Enterprises	A/AFCEnterprises
AFLAC	A/AFLAC
AFP Integra (parte de ING)	A/AFPIntegrapartedeING
Africa Israel	A/AfricaIsrael
African Bank Investments Limited (ABIL)	A/AfricanBankInvestmentsLimitedABIL
African Chrysotile Asbestos (part of Msauli)	A/AfricanChrysotileAsbestospartofMsauli
African Diamonds	A/AfricanDiamonds
African Healthcare Solutions	A/AfricanHealthcareSolutions
African International Airways	A/AfricanInternationalAirways
African Rainbow Minerals	A/AfricanRainbowMinerals
Afrika Mashariki Gold Mine (part of Placer Dome)	A/AfrikaMasharikiGoldMinepartofPlacerDome
Afrimex	A/Afrimex
Ag-Mart Produce	A/Ag-MartProduce
Age (Australia) (part of John Fairfax Holdings)	A/AgeAustraliapartofJohnFairfaxHoldings
Agere Systems	A/AgereSystems
AGF - Assurances Générales de France (part of Allianz)	A/AGF-AssurancesGnralesdeFrancepartofAllianz
Agilent Technologies	A/AgilentTechnologies
AGIP (part of ENI)	A/AGIPpartofENI
Agrexco	A/Agrexco
Agroban	A/Agroban
Agrosuper	A/Agrosuper
Aguas Argentinas (now Aguas y Saneamientos Argentinos)	A/AguasArgentinasnowAguasySaneamientosArgentinos
Aguas Claras (parte de AquaChile)	A/AguasClaraspartedeAquaChile
Aguas de Antofagasta	A/AguasdeAntofagasta
Aguas del Illimani (part of Suez)	A/AguasdelIllimanipartofSuez
Aguas y Saneamientos Argentinos	A/AguasySaneamientosArgentinos
Ahold	A/Ahold
AIG	A/AIG
Aioi Insurance	A/AioiInsurance
Air Canada	A/AirCanada
Air Cess	A/AirCess
Air China	A/AirChina
Air France KLM	A/AirFranceKLM
Air Liquide	A/AirLiquide
Air New Zealand	A/AirNewZealand
Air Products	A/AirProducts
Air-India	A/Air-India
AirAsia	A/AirAsia
Airbus	A/Airbus
Aires de Campo	A/AiresdeCampo
Airports Company South Africa (see ACSA)	A/AirportsCompanySouthAfricaseeACSA
AirScan	A/AirScan
Aisin Seiki	A/AisinSeiki
Aitech Defense Systems	A/AitechDefenseSystems
AK Steel	A/AKSteel
Akbar Brothers	A/AkbarBrothers
Aker Kvaerner	A/AkerKvaerner
Akiba Commercial Bank	A/AkibaCommercialBank
Akrokeri-Ashanti Gold	A/Akrokeri-AshantiGold
Akron (see Mexicana de Lubricantes)	A/AkronseeMexicanadeLubricantes
Aktor	A/Aktor
Akzo Nobel	A/AkzoNobel
Al Hamed Enterprises	A/AlHamedEnterprises
Alamo Rent A Car (part of Vanguard Car Rental)	A/AlamoRentACarpartofVanguardCarRental
Alaska Power & Telephone	A/AlaskaPowerTelephone
Alba (Aluminium Bahrain)	A/AlbaAluminiumBahrain
Albertsons LLC	A/AlbertsonsLLC
Alcan (now Rio Tinto Alcan)	A/AlcannowRioTintoAlcan
Alcatel (now Alcatel-Lucent)	A/AlcatelnowAlcatel-Lucent
Alcatel-Lucent	A/Alcatel-Lucent
Alcoa	A/Alcoa
Alcoa Fujikura (part of Alcoa)	A/AlcoaFujikurapartofAlcoa
Alexander Forbes	A/AlexanderForbes
Alexander Rose	A/AlexanderRose
Alexkor	A/Alexkor
Alfa 5	A/Alfa5
Alfa-Bank	A/Alfa-Bank
Alibaba.com	A/Alibabacom
Aljoma Lumber	A/AljomaLumber
Alkane Energy	A/AlkaneEnergy
All America Latina Logistica	A/AllAmericaLatinaLogistica
All Nippon Airways	A/AllNipponAirways
Allco	A/Allco
Allegheny Energy	A/AlleghenyEnergy
Allen & Overy	A/AllenOvery
Allergan	A/Allergan
Alliance & Leicester	A/AllianceLeicester
Alliance Boots	A/AllianceBoots
Alliance Capital	A/AllianceCapital
Alliance One	A/AllianceOne
Alliance Unichem (now Alliance Boots)	A/AllianceUnichemnowAllianceBoots
Alliant Energy	A/AlliantEnergy
Allianz	A/Allianz
Allied Domecq (joint venture Pernod Ricard & Fortune Brands)	A/AlliedDomecqjointventurePernodRicardFortuneBrands
Allied Irish Banks	A/AlliedIrishBanks
Allied Technologies (Altech)	A/AlliedTechnologiesAltech
Allstate	A/Allstate
Alltel	A/Alltel
Almacenar (part of Bancolombia)	A/AlmacenarpartofBancolombia
Almco	A/Almco
Almirall Prodesfarma	A/AlmirallProdesfarma
Alpargatas	A/Alpargatas
Alpha Natural Resources	A/AlphaNaturalResources
Alps Electronic	A/AlpsElectronic
Alpura	A/Alpura
Alrosa (Almazy Rossii Sakha)	A/AlrosaAlmazyRossiiSakha
Alstom	A/Alstom
Alston & Bird	A/AlstonBird
Altadis	A/Altadis
Altan Dornod Mongol	A/AltanDornodMongol
AltaVista	A/AltaVista
Altera	A/Altera
Altos Hornos de México	A/AltosHornosdeMxico
Altria	A/Altria
Alumina	A/Alumina
Aluminij	A/Aluminij
Aluminium Bahrain (see Alba)	A/AluminiumBahrainseeAlba
Aluminum Corporation of China (Chalco)	A/AluminumCorporationofChinaChalco
Alvis Vickers	A/AlvisVickers
Alyeska Pipeline	A/AlyeskaPipeline
ALZA	A/ALZA
Amaggi (part of Grupo André Maggi)	A/AmaggipartofGrupoAndrMaggi
Amalgamated Bank	A/AmalgamatedBank
Amanco (part of Grupo Nueva)	A/AmancopartofGrupoNueva
Amazon.com	A/Amazoncom
AMB Generali	A/AMBGenerali
AmBev (part of InBev)	A/AmBevpartofInBev
AMEC	A/AMEC
Amer	A/Amer
Amerada Hess (see Hess Corporation)	A/AmeradaHessseeHessCorporation
Ameren	A/Ameren
América Movil	A/AmricaMovil
American Airlines	A/AmericanAirlines
American Apparel	A/AmericanApparel
American Beryllium	A/AmericanBeryllium
American Eagle Outfitters	A/AmericanEagleOutfitters
American Electric Power	A/AmericanElectricPower
American Express	A/AmericanExpress
American Greetings	A/AmericanGreetings
American Home Products (see Wyeth)	A/AmericanHomeProductsseeWyeth
American International Group (see AIG)	A/AmericanInternationalGroupseeAIG
American Modern Insurance (part of Midland Company)	A/AmericanModernInsurancepartofMidlandCompany
American National Insurance	A/AmericanNationalInsurance
American Pad & Paper	A/AmericanPadPaper
American Standard	A/AmericanStandard
American Vanguard (AMVAC)	A/AmericanVanguardAMVAC
American Water (part of RWE)	A/AmericanWaterpartofRWE
Amerigroup	A/Amerigroup
AmerisourceBergen	A/AmerisourceBergen
Amerop Sugar	A/AmeropSugar
Amgen	A/Amgen
Amica	A/Amica
Amitié (part of El Corte Inglés)	A/AmitipartofElCorteIngls
Amorim	A/Amorim
AMP Group	A/AMPGroup
AMR (see American Airlines)	A/AMRseeAmericanAirlines
Amrop Hever Perú	A/AmropHeverPer
AmSouth	A/AmSouth
Amtrak	A/Amtrak
AMVAC (see American Vanguard)	A/AMVACseeAmericanVanguard
Amway	A/Amway
Amylin	A/Amylin
Anadarko	A/Anadarko
Analog Devices	A/AnalogDevices
And1	A/And1
Andersen Corporation	A/AndersenCorporation
Anderson Clayton	A/AndersonClayton
Anderson Columbia	A/AndersonColumbia
Anderson Fuel and Lubricants	A/AndersonFuelandLubricants
Andhra Pradesh Paper Mills	A/AndhraPradeshPaperMills
Andrade Gutierrez	A/AndradeGutierrez
Andritz	A/Andritz
Angelica	A/Angelica
Anglo American	A/AngloAmerican
Anglo Platinum (part of Anglo American)	A/AngloPlatinumpartofAngloAmerican
AngloGold Ashanti	A/AngloGoldAshanti
Anglovaal (see African Rainbow Minerals)	A/AnglovaalseeAfricanRainbowMinerals
Angola Selling Corporation (see ASCORP)	A/AngolaSellingCorporationseeASCORP
Anheuser-Busch	A/Anheuser-Busch
Ankur Seeds	A/AnkurSeeds
Ann Taylor	A/AnnTaylor
Ansell	A/Ansell
Anshan Iron & Steel (Angang)	A/AnshanIronSteelAngang
Ansul (part of Tyco)	A/AnsulpartofTyco
Antamina	A/Antamina
Antofagasta	A/Antofagasta
Antonov	A/Antonov
Anvil Ensembles	A/AnvilEnsembles
Anvil Mining	A/AnvilMining
ANZ Bank	A/ANZBank
AOL (part of Time Warner)	A/AOLpartofTimeWarner
Aon	A/Aon
Apache	A/Apache
Apasco (see Holcim Apasco)	A/ApascoseeHolcimApasco
APL Limited (part of Neptune Orient Lines)	A/APLLimitedpartofNeptuneOrientLines
Apogent Technologies	A/ApogentTechnologies
Apollo Tyres	A/ApolloTyres
Apotex	A/Apotex
APP (see Asia Pulp & Paper)	A/APPseeAsiaPulpPaper
APPH (part of BBA Aviation)	A/APPHpartofBBAAviation
Apple	A/Apple
Applebee's International	A/ApplebeesInternational
Appleby Jewellers	A/ApplebyJewellers
Applera	A/Applera
APRIL (Asia Pacific Resources International Limited)	A/APRILAsiaPacificResourcesInternationalLimited
Aptech	A/Aptech
AquaChile	A/AquaChile
Arab Bank	A/ArabBank
Arab Potash Company	A/ArabPotashCompany
"Arabian Oil, Grain and Chemical Complex"	A/ArabianOilGrainandChemicalComplex
Aracruz Celulose	A/AracruzCelulose
Aramark	A/Aramark
Aramex	A/Aramex
Arauco (see Celulosa Arauco y Constitución)	A/AraucoseeCelulosaAraucoyConstitucin
Arcadia Group	A/ArcadiaGroup
Arcelor (now Arcelor Mittal)	A/ArcelornowArcelorMittal
Arcelor Mittal	A/ArcelorMittal
Arch Chemicals	A/ArchChemicals
Arch Coal	A/ArchCoal
Archer Daniels Midland	A/ArcherDanielsMidland
Archipelago Resources	A/ArchipelagoResources
Arco (part of BP)	A/ArcopartofBP
Arcor	A/Arcor
Arena	A/Arena
Arent Fox	A/ArentFox
Areva	A/Areva
Argenbright (part of Group 4 Securicor)	A/ArgenbrightpartofGroup4Securicor
Argenti Lemon	A/ArgentiLemon
Argos (part of Home Retail Group)	A/ArgospartofHomeRetailGroup
ARINC	A/ARINC
Arizona Public Service Company (part of Pinnacle West Capital)	A/ArizonaPublicServiceCompanypartofPinnacleWestCapital
Arja Textile	A/ArjaTextile
Arkema (part of Total)	A/ArkemapartofTotal
Arla Foods	A/ArlaFoods
Arm Holdings	A/ArmHoldings
Armani (see Giorgio Armani)	A/ArmaniseeGiorgioArmani
ArmorGroup	A/ArmorGroup
Armour Pharmaceutical	A/ArmourPharmaceutical
Armstrong	A/Armstrong
Arnold & Porter	A/ArnoldPorter
Arsenal	A/Arsenal
Arup	A/Arup
ArvinMeritor	A/ArvinMeritor
Asarco (part of Grupo México)	A/AsarcopartofGrupoMxico
Asbury Automotive	A/AsburyAutomotive
Ascendant Copper	A/AscendantCopper
Ascendant Holdings	A/AscendantHoldings
"ASCORP (Angola Selling Corporation) (joint venture Endiama, Lev Leviev Group, Omega Diamonds)"	A/ASCORPAngolaSellingCorporationjointventureEndiamaLevLevievGroupOmegaDiamonds
ASDA (part of Wal-Mart)	A/ASDApartofWal-Mart
ASET Capital	A/ASETCapital
Ash Grove Cement	A/AshGroveCement
Ashanti Goldfields (see AngloGold Ashanti)	A/AshantiGoldfieldsseeAngloGoldAshanti
Ashland	A/Ashland
Ashok Leyland	A/AshokLeyland
Asia Energy	A/AsiaEnergy
Asia Pacific Resources	A/AsiaPacificResources
Asia Pulp & Paper (part of Sinar Mas)	A/AsiaPulpPaperpartofSinarMas
Asian Paints	A/AsianPaints
Asiana Airlines	A/AsianaAirlines
Asics	A/Asics
Askar Security Services	A/AskarSecurityServices
Asociación Chilena de Seguridad	A/AsociacinChilenadeSeguridad
Aspen Insurance	A/AspenInsurance
Aspen Pharmacare	A/AspenPharmacare
Aspen Skiing Company	A/AspenSkiingCompany
Asprey (part of A&G Group)	A/AspreypartofAGGroup
Assicurazioni Generali	A/AssicurazioniGenerali
Assmang	A/Assmang
Associated British Foods	A/AssociatedBritishFoods
Associated British Ports	A/AssociatedBritishPorts
Associated Cement (see ACC Limited)	A/AssociatedCementseeACCLimited
Assore	A/Assore
AstraZeneca	A/AstraZeneca
Asturiana de Zinc (part of Xstrata)	A/AsturianadeZincpartofXstrata
AT&T	A/ATT
ATDI	A/ATDI
Atlantic Container Line	A/AtlanticContainerLine
Atlas Copco	A/AtlasCopco
Atofina (see Arkema)	A/AtofinaseeArkema
Atos Origin	A/AtosOrigin
ATP Insaat (part of Koza Davetiye)	A/ATPInsaatpartofKozaDavetiye
Attila Dogan	A/AttilaDogan
Atwood Oceanics	A/AtwoodOceanics
Auchan	A/Auchan
Aurafin	A/Aurafin
Aurobindo Pharmaceuticals	A/AurobindoPharmaceuticals
Aurora Gold	A/AuroraGold
Austindo Resources	A/AustindoResources
Australand	A/Australand
Australia Post	A/AustraliaPost
Australian Ethical Investment	A/AustralianEthicalInvestment
Austrian Airlines	A/AustrianAirlines
AutoNation	A/AutoNation
Autopistas del Sol	A/AutopistasdelSol
Autostrade	A/Autostrade
AutoZone	A/AutoZone
Avalon	A/Avalon
Avaya	A/Avaya
Aveda (part of Estée Lauder)	A/AvedapartofEsteLauder
Avent	A/Avent
Aventis (now part of Sanofi-Aventis)	A/AventisnowpartofSanofi-Aventis
Avery Dennison	A/AveryDennison
Avia Baltika	A/AviaBaltika
Avianca	A/Avianca
Aviation Development Corporation (ADC)	A/AviationDevelopmentCorporationADC
Aviatur	A/Aviatur
Avient Air	A/AvientAir
Avis Budget	A/AvisBudget
Aviva	A/Aviva
Avnel Gold	A/AvnelGold
Avon	A/Avon
AXA	A/AXA
Axel Springer	A/AxelSpringer
Axfood	A/Axfood
Axminster Carpets	A/AxminsterCarpets
Ayala	A/Ayala
AZSA & Co (part of KPMG)	A/AZSACopartofKPMG
Azteca Foods	A/AztecaFoods
Azucarera los Balcanes	A/AzucareralosBalcanes
B&H Photo-Video	B/BHPhoto-Video
B&Q (part of Kingfisher)	B/BQpartofKingfisher
B. Braun Melsungen	B/BBraunMelsungen
BAA (see British Airports Authority)	B/BAAseeBritishAirportsAuthority
Babelito	B/Babelito
Bacardi	B/Bacardi
BAE Systems	B/BAESystems
Bagan Cyber	B/BaganCyber
Bagir	B/Bagir
Bai Xing Magazine	B/BaiXingMagazine
Baidu	B/Baidu
Baiyin Non-ferrous Metal	B/BaiyinNon-ferrousMetal
Bajaj Auto	B/BajajAuto
Baker Hughes	B/BakerHughes
Bakwanga Mining Company (see MIBA)	B/BakwangaMiningCompanyseeMIBA
Baldor Electric	B/BaldorElectric
Balfour Beatty	B/BalfourBeatty
Ball Corp.	B/BallCorp
Ballarpur Industries	B/BallarpurIndustries
Bally Total Fitness	B/BallyTotalFitness
Banacol	B/Banacol
Banadex	B/Banadex
Banamex (part of Citigroup)	B/BanamexpartofCitigroup
Banana Republic (part of Gap)	B/BananaRepublicpartofGap
Banca Intesa (part of Intesa Sanpaolo)	B/BancaIntesapartofIntesaSanpaolo
Banca Nazionale del Lavoro	B/BancaNazionaledelLavoro
Bancaja	B/Bancaja
Banco Atlántida	B/BancoAtlntida
Banco Azteca	B/BancoAzteca
Banco BPI	B/BancoBPI
Banco Bradesco	B/BancoBradesco
Banco Caja Social	B/BancoCajaSocial
Banco Comercial Portugues	B/BancoComercialPortugues
Banco del Pichincha	B/BancodelPichincha
Banco do Brasil	B/BancodoBrasil
Banco Espírito Santo	B/BancoEspritoSanto
Banco Francés (part of BBVA)	B/BancoFrancspartofBBVA
Banco Galicia	B/BancoGalicia
Banco Itau	B/BancoItau
Banco Nacional de México (see Banamex)	B/BancoNacionaldeMxicoseeBanamex
Banco Real (part of ABN Amro)	B/BancoRealpartofABNAmro
Banco Santander (see Santander)	B/BancoSantanderseeSantander
Bancolombia	B/Bancolombia
Bandai	B/Bandai
Bandecua (part of Fresh Del Monte Produce)	B/BandecuapartofFreshDelMonteProduce
Bandeirante Energia	B/BandeiranteEnergia
Banesto	B/Banesto
Bangkok Bank	B/BangkokBank
Bank Austria Creditanstalt	B/BankAustriaCreditanstalt
Bank Hapoalim	B/BankHapoalim
Bank Negara Indonesia	B/BankNegaraIndonesia
Bank of America	B/BankofAmerica
Bank of China	B/BankofChina
Bank of Montreal	B/BankofMontreal
Bank of New York	B/BankofNewYork
Bank of Nova Scotia	B/BankofNovaScotia
Bank of Palestine	B/BankofPalestine
Bank of Tokyo-Mitsubishi	B/BankofTokyo-Mitsubishi
Bank One (part of JPMorgan Chase)	B/BankOnepartofJPMorganChase
Bank Sarasin	B/BankSarasin
Bank West (part of HBOS)	B/BankWestpartofHBOS
Banorte	B/Banorte
Banpu	B/Banpu
Banque Populaire (see Groupe Banque Populaire)	B/BanquePopulaireseeGroupeBanquePopulaire
Banyan Tree	B/BanyanTree
Baogang	B/Baogang
Baotou Iron & Steel (see Baogang)	B/BaotouIronSteelseeBaogang
Baran	B/Baran
Barclays	B/Barclays
Bard (see C.R. Bard)	B/BardseeCRBard
Barito Pacific Timber	B/BaritoPacificTimber
Barloworld	B/Barloworld
Barnes & Noble	B/BarnesNoble
Barratts	B/Barratts
Barrett Resources (part of Williams Companies)	B/BarrettResourcespartofWilliamsCompanies
Barrick Gold	B/BarrickGold
Barry Callebaut	B/BarryCallebaut
BASF	B/BASF
Basic Petroleum	B/BasicPetroleum
Basix	B/Basix
Bass (part of InBev)	B/BasspartofInBev
BAT (see British American Tobacco)	B/BATseeBritishAmericanTobacco
Bata	B/Bata
Bauer Nike Hockey (part of Nike)	B/BauerNikeHockeypartofNike
Bausch & Lomb	B/BauschLomb
Bavaria (part of SABMiller)	B/BavariapartofSABMiller
Bawag P.S.K.	B/BawagPSK
Baxter International	B/BaxterInternational
Bayer	B/Bayer
Bayer Schering (part of Bayer)	B/BayerScheringpartofBayer
BB&T	B/BBT
BBA Aviation	B/BBAAviation
BBC	B/BBC
BBVA	B/BBVA
BC Hydro	B/BCHydro
BCL	B/BCL
"BD (Becton, Dickinson)"	B/BDBectonDickinson
BearingPoint	B/BearingPoint
Bebidas y Alimentos	B/BebidasyAlimentos
Bechtel	B/Bechtel
Beck's (part of InBev)	B/BeckspartofInBev
Beckman Coulter	B/BeckmanCoulter
BECOL (part of Fortis)	B/BECOLpartofFortis
"Becton, Dickinson (see BD)"	B/BectonDickinsonseeBD
Bed Bath & Beyond	B/BedBathBeyond
Befesa	B/Befesa
Beiersdorf	B/Beiersdorf
Beijing General Research Institute of Mining & Metallurgy (BGRIMM)	B/BeijingGeneralResearchInstituteofMiningMetallurgyBGRIMM
Beijing Laowan Bioenergy Technology	B/BeijingLaowanBioenergyTechnology
Beijing Organic Foods	B/BeijingOrganicFoods
Beijing Urban Construction Group	B/BeijingUrbanConstructionGroup
Belcorp	B/Belcorp
Belgo Mineira (part of Arcelor Mittal)	B/BelgoMineirapartofArcelorMittal
Bell Helicopter (part of Textron)	B/BellHelicopterpartofTextron
Bellhaven Copper & Gold	B/BellhavenCopperGold
BellSouth (now AT&T)	B/BellSouthnowATT
Bemis	B/Bemis
Ben & Jerry's (part of Unilever)	B/BenJerryspartofUnilever
Ben Line Agencies	B/BenLineAgencies
Benetton	B/Benetton
Benguet	B/Benguet
Bensimon	B/Bensimon
Beowulf International	B/BeowulfInternational
Beretta	B/Beretta
Berkshire Hathaway	B/BerkshireHathaway
Berli Jucker	B/BerliJucker
Bernard Callebaut	B/BernardCallebaut
Bernas	B/Bernas
Bertelsmann	B/Bertelsmann
Best Buy	B/BestBuy
Best Western	B/BestWestern
Bestseller	B/Bestseller
BET (part of Viacom)	B/BETpartofViacom
Bethlehem Apparatus	B/BethlehemApparatus
Bezeq	B/Bezeq
BG Group	B/BGGroup
BHP Billiton	B/BHPBilliton
BHS	B/BHS
Bilbaína de Alquitranes	B/BilbanadeAlquitranes
Bilfinger Berger	B/BilfingerBerger
Bimbo	B/Bimbo
Bioderma	B/Bioderma
Biofer	B/Biofer
Biolab (part of Chemtura)	B/BiolabpartofChemtura
bioMérieux	B/bioMrieux
Birim Goldfields	B/BirimGoldfields
Birzeit Pharmaceutical Company	B/BirzeitPharmaceuticalCompany
Bivings Group	B/BivingsGroup
Biwater	B/Biwater
BJ&B	B/BJB
BJ's Wholesale Club	B/BJsWholesaleClub
Black and Veatch	B/BlackandVeatch
Black Canyon	B/BlackCanyon
Blackwater	B/Blackwater
Blackwell Publishing	B/BlackwellPublishing
Blockbuster	B/Blockbuster
Blommer Chocolate	B/BlommerChocolate
Bloomberg	B/Bloomberg
Bloomingdales (part of Federated Department Stores)	B/BloomingdalespartofFederatedDepartmentStores
Blue Cross	B/BlueCross
Bluelinx	B/Bluelinx
BlueScope Steel	B/BlueScopeSteel
BM Polyco	B/BMPolyco
BMW	B/BMW
BNFL	B/BNFL
BNP Paribas	B/BNPParibas
Boards & More	B/BoardsMore
BOC Group	B/BOCGroup
Bodegas Chandon (part of LVMH)	B/BodegasChandonpartofLVMH
Body Shop (part of L'Oréal)	B/BodyShoppartofLOral
Boehringer Ingelheim	B/BoehringerIngelheim
Boeing	B/Boeing
Bogner	B/Bogner
Boise Cascade	B/BoiseCascade
Boliden	B/Boliden
Bombardier	B/Bombardier
Bon Appetit Management	B/BonAppetitManagement
Bonnier Group	B/BonnierGroup
Bontan	B/Bontan
Bonte Gold Mines (part of Akrokeri-Ashanti Gold)	B/BonteGoldMinespartofAkrokeri-AshantiGold
Boodle & Dunthorne	B/BoodleDunthorne
Boon & Sons	B/BoonSons
Boots (now Alliance Boots)	B/BootsnowAllianceBoots
Booz Allen Hamilton	B/BoozAllenHamilton
Boras Wäfveri	B/BorasWfveri
Borders	B/Borders
BorgWarner	B/BorgWarner
BOS International (part of HBOS)	B/BOSInternationalpartofHBOS
Bosch	B/Bosch
Boskalis (see Royal Boskalis Westminster)	B/BoskalisseeRoyalBoskalisWestminster
Bossini	B/Bossini
Boston Common Asset Mgmt.	B/BostonCommonAssetMgmt
Boston Market (part of McDonald's)	B/BostonMarketpartofMcDonalds
Botas	B/Botas
Botnia	B/Botnia
Boucheron (part of Gucci)	B/BoucheronpartofGucci
Boutique Jacob	B/BoutiqueJacob
Bouygues	B/Bouygues
Bovis Lend Lease	B/BovisLendLease
Bowater	B/Bowater
Bozovich	B/Bozovich
BP	B/BP
BR-111	B/BR-111
Bracken Jewelers	B/BrackenJewelers
Brambles	B/Brambles
Branch Banking & Trust (see BB&T)	B/BranchBankingTrustseeBBT
Brandix	B/Brandix
Bravo (part of NBC)	B/BravopartofNBC
Brazilian Diamonds	B/BrazilianDiamonds
Breed Technologies	B/BreedTechnologies
Brenco International	B/BrencoInternational
Brenntag	B/Brenntag
Bridas	B/Bridas
Bridgestone	B/Bridgestone
Bridgestone-Firestone (part of Bridgestone)	B/Bridgestone-FirestonepartofBridgestone
Brigard & Urrutia	B/BrigardUrrutia
Bright Horizons	B/BrightHorizons
Brine	B/Brine
Brio	B/Brio
Briscoe	B/Briscoe
Bristol & West plc	B/BristolWestplc
Bristol-Myers Squibb	B/Bristol-MyersSquibb
British Airports Authority (BAA)	B/BritishAirportsAuthorityBAA
British Airways	B/BritishAirways
British American Tobacco	B/BritishAmericanTobacco
British American Tobacco Nigeria (part of British American Tobacco)	B/BritishAmericanTobaccoNigeriapartofBritishAmericanTobacco
British Energy	B/BritishEnergy
British Gas (part of Centrica)	B/BritishGaspartofCentrica
British Land	B/BritishLand
British Midland	B/BritishMidland
British Sky Broadcasting	B/BritishSkyBroadcasting
Broad Air Conditioning	B/BroadAirConditioning
Brocock	B/Brocock
Brodrene Hartmann (see Hartmann)	B/BrodreneHartmannseeHartmann
Brooks Brothers	B/BrooksBrothers
Brookstone	B/Brookstone
Brown & Williamson (now Reynolds American)	B/BrownWilliamsonnowReynoldsAmerican
Brown Shoe	B/BrownShoe
Brunner Mond	B/BrunnerMond
Brunswick	B/Brunswick
Brylane (part of Pinault Printemps-Redoute)	B/BrylanepartofPinaultPrintemps-Redoute
BSkyB (see British Sky Broadcasting)	B/BSkyBseeBritishSkyBroadcasting
BT	B/BT
BT Financial (part of Westpac)	B/BTFinancialpartofWestpac
Buca	B/Buca
Budweiser (part of Anheuser-Busch)	B/BudweiserpartofAnheuser-Busch
Buenaventura	B/Buenaventura
Bulgari	B/Bulgari
Bull	B/Bull
Bunge	B/Bunge
Bunnings Warehouse	B/BunningsWarehouse
BUPA	B/BUPA
Burberry (part of GUS)	B/BurberrypartofGUS
Burger King	B/BurgerKing
Burke Group	B/BurkeGroup
Burlington Northern & Santa Fe Railway (BNSF)	B/BurlingtonNorthernSantaFeRailwayBNSF
Burlington Resources (part of ConocoPhillips)	B/BurlingtonResourcespartofConocoPhillips
Burson-Marsteller	B/Burson-Marsteller
Bushmaster	B/Bushmaster
BYD	B/BYD
Çalik Holding	C/alikHolding
C & A	C/CA
C-BONS Group	C/C-BONSGroup
C. F. Martin	C/CFMartin
C.R. Bard	C/CRBard
Cable and Wireless	C/CableandWireless
Cablevision	C/Cablevision
Cabot Corporation	C/CabotCorporation
CACI	C/CACI
Cadbury Schweppes	C/CadburySchweppes
Café de Coral	C/CafdeCoral
Cafédirect	C/Cafdirect
Cahya Mata Sarawak (CMS)	C/CahyaMataSarawakCMS
Cainafunuo Wood	C/CainafunuoWood
Cairn Energy	C/CairnEnergy
Caisse d'Epargne	C/CaissedEpargne
Caisse des Dépôts	C/CaissedesDpts
Caja Madrid	C/CajaMadrid
Caja Navarra	C/CajaNavarra
CajaGranada	C/CajaGranada
Cal-Comp Electronics	C/Cal-CompElectronics
Calpine	C/Calpine
Caltex	C/Caltex
Calvin Klein (part of Phillips-Van Heusen)	C/CalvinKleinpartofPhillips-VanHeusen
Calyon (part of Crédit Agricole)	C/CalyonpartofCrditAgricole
Cambior	C/Cambior
Cambrian	C/Cambrian
Cameco	C/Cameco
CamelBak	C/CamelBak
Camelot	C/Camelot
Cameroon Oil Transportation	C/CameroonOilTransportation
Camif	C/Camif
Cammell Laird	C/CammellLaird
Campbell Soup	C/CampbellSoup
Camper	C/Camper
Canadian Imperial Bank of Commerce (CIBC)	C/CanadianImperialBankofCommerceCIBC
Canadian Natural Resources	C/CanadianNaturalResources
Canara Bank	C/CanaraBank
Canary Wharf	C/CanaryWharf
Canon	C/Canon
CanWest Global Communications	C/CanWestGlobalCommunications
Cape Cod Potato Chip (part of Lance)	C/CapeCodPotatoChippartofLance
Cape PLC	C/CapePLC
Capgemini	C/Capgemini
Capital & Credit Financial	C/CapitalCreditFinancial
Capital One	C/CapitalOne
CAPS	C/CAPS
Cara Operations	C/CaraOperations
Carbones del Caribe	C/CarbonesdelCaribe
Carbozulia (part of PDVSA)	C/CarbozuliapartofPDVSA
Carcafe (part of ED&F Man)	C/CarcafepartofEDFMan
Cárdenas & Cárdenas	C/CrdenasCrdenas
Cardinal	C/Cardinal
Cargill	C/Cargill
Cargo	C/Cargo
Cargolux	C/Cargolux
Carillion	C/Carillion
Carl Walther	C/CarlWalther
Carlos Casado	C/CarlosCasado
Carlsberg Breweries	C/CarlsbergBreweries
Carlson	C/Carlson
Carlyle Group	C/CarlyleGroup
Carnival	C/Carnival
Carphone Warehouse	C/CarphoneWarehouse
Carrefour	C/Carrefour
Carrier (part of United Technologies)	C/CarrierpartofUnitedTechnologies
Carritt Moran	C/CarrittMoran
Carter's	C/Carters
Cartier (part of Richemont)	C/CartierpartofRichemont
Casas Bahia	C/CasasBahia
Casella	C/Casella
Casino	C/Casino
Casio	C/Casio
Caterpillar	C/Caterpillar
Cathay Pacific	C/CathayPacific
Cato	C/Cato
CBA (Companhia Brasileira de Aluminio)	C/CBACompanhiaBrasileiradeAluminio
CBRL Group	C/CBRLGroup
CBS	C/CBS
CDO Foodsphere	C/CDOFoodsphere
"Cegetel (joint venture SNCF, Vivendi Universal & Vodafone)"	C/CegeteljointventureSNCFVivendiUniversalVodafone
Celebrity Cruises (part of Royal Caribbean Cruises)	C/CelebrityCruisespartofRoyalCaribbeanCruises
Celestica	C/Celestica
Celio	C/Celio
Celtel	C/Celtel
Celulosa Arauco y Constitución (CELCO)	C/CelulosaAraucoyConstitucinCELCO
CEM (part of Tractebel)	C/CEMpartofTractebel
Cement Roadstone Holdings (see CRH)	C/CementRoadstoneHoldingsseeCRH
Cemento Cibao	C/CementoCibao
Cementos Argos	C/CementosArgos
Cementos Lima	C/CementosLima
Cementos Portland Moctezuma (part of Corporación Moctezuma)	C/CementosPortlandMoctezumapartofCorporacinMoctezuma
Cemex	C/Cemex
Cémoi	C/Cmoi
Cencosud	C/Cencosud
Cendant (now Avis Budget)	C/CendantnowAvisBudget
Centennial Coal	C/CentennialCoal
CenterPoint Energy	C/CenterPointEnergy
Centerra Gold (part of Cameco)	C/CenterraGoldpartofCameco
Centex	C/Centex
Central Azucarera de Tarlac	C/CentralAzucareradeTarlac
Central Azucarera Don Pedro	C/CentralAzucareraDonPedro
Central Izalco	C/CentralIzalco
Central Japan Railway	C/CentralJapanRailway
Central Warehousing Corporation	C/CentralWarehousingCorporation
Centrica	C/Centrica
Centrosolar	C/Centrosolar
Century 21 Real Estate	C/Century21RealEstate
Cenzin	C/Cenzin
Cerberus Capital Management	C/CerberusCapitalManagement
Ceres Hellenic Shipping Enterprises	C/CeresHellenicShippingEnterprises
Cermaq	C/Cermaq
Cerner	C/Cerner
"Cerrejón Coal (joint venture Anglo American, BHP Billiton, Xstrata)"	C/CerrejnCoaljointventureAngloAmericanBHPBillitonXstrata
Cerro Matoso (part of BHP Billiton)	C/CerroMatosopartofBHPBilliton
Cerro Vanguardia (joint venture AngloGold Ashanti and Formicruz)	C/CerroVanguardiajointventureAngloGoldAshantiandFormicruz
CertainTeed (part of Saint-Gobain)	C/CertainTeedpartofSaint-Gobain
Cesce	C/Cesce
Ceská zbrojovka	C/Ceskzbrojovka
Ceylon Express	C/CeylonExpress
CFAO (part of Pinault-Printemps-Redoute)	C/CFAOpartofPinault-Printemps-Redoute
CGC (see Compañía General de Combustibles)	C/CGCseeCompaaGeneraldeCombustibles
Chalco (see Aluminum Corporation of China)	C/ChalcoseeAluminumCorporationofChina
Challenger Financial Services	C/ChallengerFinancialServices
Chambishi Metals	C/ChambishiMetals
Champion (part of Hanesbrands)	C/ChampionpartofHanesbrands
Chanel	C/Chanel
Changan	C/Changan
Changshu 3F Zhonghao New Chemical Materials (part of Shanghai 3F New Chemical Materials)	C/Changshu3FZhonghaoNewChemicalMaterialspartofShanghai3FNewChemicalMaterials
Changzheng Building Materials	C/ChangzhengBuildingMaterials
Chapuis Armes - Manurhin	C/ChapuisArmes-Manurhin
Charles Schwab	C/CharlesSchwab
Charming Shoppes	C/CharmingShoppes
Charoen Pokphand (see CP)	C/CharoenPokphandseeCP
Chas Schwartz & Son	C/ChasSchwartzSon
Chase (part of JPMorgan Chase)	C/ChasepartofJPMorganChase
Chase Electronics	C/ChaseElectronics
CHC	C/CHC
Chef Solutions (part of Questor)	C/ChefSolutionspartofQuestor
Chemaf	C/Chemaf
Chemtura	C/Chemtura
Chenfeng Group	C/ChenfengGroup
Chengda	C/Chengda
Chenming Paper	C/ChenmingPaper
Chennai Petroleum Corporation	C/ChennaiPetroleumCorporation
Chenshen Group	C/ChenshenGroup
Chentex	C/Chentex
Cherokee	C/Cherokee
Chesapeake Energy	C/ChesapeakeEnergy
Cheung Kong	C/CheungKong
Chevalier	C/Chevalier
Chevignon (part of Naf Naf)	C/ChevignonpartofNafNaf
Chevron	C/Chevron
Chia Khim Lee	C/ChiaKhimLee
Chia Tai China (part of CP)	C/ChiaTaiChinapartofCP
Chiba Bank	C/ChibaBank
Chicco	C/Chicco
Chickeeduck	C/Chickeeduck
Chigo Air-Conditioning	C/ChigoAir-Conditioning
Children's Place	C/ChildrensPlace
Chiletabacos	C/Chiletabacos
China Academy of Telecommunication Technology	C/ChinaAcademyofTelecommunicationTechnology
China Airlines	C/ChinaAirlines
China Aviation Supplies Imp. & Exp.	C/ChinaAviationSuppliesImpExp
China Construction Bank	C/ChinaConstructionBank
China Exim	C/ChinaExim
China Floors (see Cainafunuo Wood)	C/ChinaFloorsseeCainafunuoWood
China Gezhouba	C/ChinaGezhouba
China Guodian	C/ChinaGuodian
China Huadian	C/ChinaHuadian
China Huaneng Group	C/ChinaHuanengGroup
China International Marine Containers	C/ChinaInternationalMarineContainers
China International Trust and Investment (CITIC)	C/ChinaInternationalTrustandInvestmentCITIC
China International Water & Electric (CWE)	C/ChinaInternationalWaterElectricCWE
China Life Insurance	C/ChinaLifeInsurance
China Merchants	C/ChinaMerchants
China Merchants Bank	C/ChinaMerchantsBank
China Minmetals	C/ChinaMinmetals
China Mobile	C/ChinaMobile
China National Electric Equipment (CNEEC)	C/ChinaNationalElectricEquipmentCNEEC
China National Heavy Machinery	C/ChinaNationalHeavyMachinery
China National Offshore Oil Corporation (see CNOOC)	C/ChinaNationalOffshoreOilCorporationseeCNOOC
China National Petroleum Corporation (CNPC)	C/ChinaNationalPetroleumCorporationCNPC
China National Water Resources & Hydropower Engineering (see Sinohydro)	C/ChinaNationalWaterResourcesHydropowerEngineeringseeSinohydro
China Netcom	C/ChinaNetcom
China Non-ferrous Metal Industrys Foreign Engineering & Construction (NFC)	C/ChinaNon-ferrousMetalIndustrysForeignEngineeringConstructionNFC
China North Industries (see NORINCO)	C/ChinaNorthIndustriesseeNORINCO
China Ocean Shipping	C/ChinaOceanShipping
China Petroleum & Chemical (see Sinopec)	C/ChinaPetroleumChemicalseeSinopec
China Pingan Insurance	C/ChinaPinganInsurance
China Power Investment	C/ChinaPowerInvestment
China Public Security Technology (CPST)	C/ChinaPublicSecurityTechnologyCPST
China Railway Engineer	C/ChinaRailwayEngineer
China Resources Breweries (joint venture China Resources Enterprises & SABMiller)	C/ChinaResourcesBreweriesjointventureChinaResourcesEnterprisesSABMiller
China Resources Enterprises	C/ChinaResourcesEnterprises
China Shenhua Energy (part of Shenhua Group)	C/ChinaShenhuaEnergypartofShenhuaGroup
China Southern Power Grid	C/ChinaSouthernPowerGrid
China Steel	C/ChinaSteel
China Synthetic Rubber	C/ChinaSyntheticRubber
China Telecom	C/ChinaTelecom
China Three Gorges Project Corporation	C/ChinaThreeGorgesProjectCorporation
China TUHSU	C/ChinaTUHSU
China Water	C/ChinaWater
China Yituo	C/ChinaYituo
Chiquita	C/Chiquita
Chiron	C/Chiron
Chisso	C/Chisso
Chitotolo (Sociedade Mineira do Chitotolo)	C/ChitotoloSociedadeMineiradoChitotolo
Chiyoda	C/Chiyoda
Choice Hotels	C/ChoiceHotels
ChoicePoint	C/ChoicePoint
Chong Won	C/ChongWon
Chongqing Electric Power (part of State Grid Corporation of China)	C/ChongqingElectricPowerpartofStateGridCorporationofChina
ChongQing Jinbiao Biotechnology	C/ChongQingJinbiaoBiotechnology
Chongqing Jiulong Electric Power	C/ChongqingJiulongElectricPower
Chongqing Lifan Industry	C/ChongqingLifanIndustry
Christian Bernard	C/ChristianBernard
Chrome Energy	C/ChromeEnergy
CHS	C/CHS
Chubb Group	C/ChubbGroup
Chugoku Electric Power	C/ChugokuElectricPower
Chunghwa Telecom	C/ChunghwaTelecom
ChuoAoyama Audit (part of PricewaterhouseCoopers)	C/ChuoAoyamaAuditpartofPricewaterhouseCoopers
Church & Dwight	C/ChurchDwight
Ciba Specialty Chemicals	C/CibaSpecialtyChemicals
Cicam (Cotonnière Industrielle du Cameroun)	C/CicamCotonnireIndustrielleduCameroun
CIGNA	C/CIGNA
Ciments du Sahel	C/CimentsduSahel
Cimpor	C/Cimpor
Cincinnati Bell	C/CincinnatiBell
Cincinnati Financial	C/CincinnatiFinancial
Cinemex	C/Cinemex
Cinergy (now Duke Energy)	C/CinergynowDukeEnergy
Cingular Wireless (now AT&T)	C/CingularWirelessnowATT
Cintas	C/Cintas
Cipla	C/Cipla
Circuit City	C/CircuitCity
Cirque du Soleil	C/CirqueduSoleil
Cisco Systems	C/CiscoSystems
CIT	C/CIT
Citibank (part of Citigroup)	C/CitibankpartofCitigroup
CITIC Pacific	C/CITICPacific
Citigroup	C/Citigroup
Citroën (see PSA Peugeot-Citroën)	C/CitronseePSAPeugeot-Citron
Citromax	C/Citromax
City West Water	C/CityWestWater
CJ	C/CJ
CKE Restaurants	C/CKERestaurants
Clariant	C/Clariant
Clarks	C/Clarks
Cleanaway (part of Brambles)	C/CleanawaypartofBrambles
Cleansing Service Group	C/CleansingServiceGroup
Clear Channel	C/ClearChannel
Clif Bar	C/ClifBar
Clifford Chance	C/CliffordChance
Climax Mining	C/ClimaxMining
Clorox	C/Clorox
CLP Holdings	C/CLPHoldings
CM Group	C/CMGroup
CMEC (China National Machinery & Equipment)	C/CMECChinaNationalMachineryEquipment
CMP Media (part of United Business Media)	C/CMPMediapartofUnitedBusinessMedia
CMS Energy	C/CMSEnergy
CNA	C/CNA
CNGC	C/CNGC
CNOOC (China National Offshore Oil Corporation)	C/CNOOCChinaNationalOffshoreOilCorporation
CNP Assurances	C/CNPAssurances
CNPC (see China National Petroleum Corporation)	C/CNPCseeChinaNationalPetroleumCorporation
CNSC	C/CNSC
CNSC Fortune Way (part of CNSC)	C/CNSCFortuneWaypartofCNSC
Co-operative Bank (part of Co-operative Group)	C/Co-operativeBankpartofCo-operativeGroup
Co-operative Bank of Kenya	C/Co-operativeBankofKenya
Co-operative Financial Services (CFS) (part of Co-operative Group)	C/Co-operativeFinancialServicesCFSpartofCo-operativeGroup
Co-operative Group	C/Co-operativeGroup
Co-operative Insurance Society (part of Co-operative Group)	C/Co-operativeInsuranceSocietypartofCo-operativeGroup
Coates Hire	C/CoatesHire
Coca-Cola	C/Coca-Cola
Coca-Cola FEMSA	C/Coca-ColaFEMSA
Codelco	C/Codelco
Coeur d'Alene	C/CoeurdAlene
COGEMA (part of Areva)	C/COGEMApartofAreva
Cognis	C/Cognis
COK Co-operative Credit Union	C/COKCo-operativeCreditUnion
Colbún	C/Colbn
Cole & Ashcroft	C/ColeAshcroft
Cole Specialty Systems	C/ColeSpecialtySystems
Coles Group	C/ColesGroup
Colgate-Palmolive	C/Colgate-Palmolive
Collegiate Licensing	C/CollegiateLicensing
Collum Coal Mining	C/CollumCoalMining
Colmena	C/Colmena
Colonial First State	C/ColonialFirstState
Colonial Pipeline	C/ColonialPipeline
Columbia Sportswear	C/ColumbiaSportswear
Columbus Stainless	C/ColumbusStainless
Comcast	C/Comcast
Comcraft Kenya	C/ComcraftKenya
Comercial Mexicana	C/ComercialMexicana
Comercializadora Internacional Santandereana de Aceites (see Saceites)	C/ComercializadoraInternacionalSantandereanadeAceitesseeSaceites
Comerica	C/Comerica
Comfort Inn (part of Choice Hotels)	C/ComfortInnpartofChoiceHotels
Comisión Federal de Electricidad	C/ComisinFederaldeElectricidad
Commemorative Brands (part of American Achievement)	C/CommemorativeBrandspartofAmericanAchievement
Commercial Metals	C/CommercialMetals
Commerzbank	C/Commerzbank
Commonwealth Bank	C/CommonwealthBank
Compagnie Ivoirienne d'Electricité (CIE)	C/CompagnieIvoiriennedElectricitCIE
Compagnie Mauricienne de Textile (CMT)	C/CompagnieMauriciennedeTextileCMT
Companhia Paranaense de Energia (COPEL)	C/CompanhiaParanaensedeEnergiaCOPEL
Companhia Siderúrgica de Tubarão (CST)	C/CompanhiaSiderrgicadeTubaroCST
Companhia Vale do Rio Doce	C/CompanhiaValedoRioDoce
Compaq (part of HP)	C/CompaqpartofHP
Compass Group	C/CompassGroup
Compañía Azucarera Salvadoreña	C/CompaaAzucareraSalvadorea
Compañía de Galletas Noel	C/CompaadeGalletasNoel
Compañía de Tierras del Sud Argentino (part of Benetton)	C/CompaadeTierrasdelSudArgentinopartofBenetton
Compañía Envasadora del Atlántico	C/CompaaEnvasadoradelAtlntico
Compañía Fresnillo	C/CompaaFresnillo
Compañía General de Combustibles (part of Southern Cross)	C/CompaaGeneraldeCombustiblespartofSouthernCross
Compañía Guatemalteca de Níquel (CGN) (part of Skye Resources)	C/CompaaGuatemaltecadeNquelCGNpartofSkyeResources
Complementos Alimentarios de Zaidín (CAZSA)	C/ComplementosAlimentariosdeZaidnCAZSA
Compton Jewelers	C/ComptonJewelers
Computer Sciences	C/ComputerSciences
Computime	C/Computime
Con Edison	C/ConEdison
ConAgra	C/ConAgra
Concord Pacific	C/ConcordPacific
Conforama (part of Pinault-Printemps-Redoute)	C/ConforamapartofPinault-Printemps-Redoute
Connex (part of Veolia Environnement)	C/ConnexpartofVeoliaEnvironnement
ConocoPhillips	C/ConocoPhillips
Consignia	C/Consignia
Consol Energy	C/ConsolEnergy
Consolidated Bank of Kenya	C/ConsolidatedBankofKenya
Constellation Energy	C/ConstellationEnergy
Continental AG	C/ContinentalAG
Continental Airlines	C/ContinentalAirlines
Continental Carbon	C/ContinentalCarbon
Continental Clothing	C/ContinentalClothing
Continuum Resources	C/ContinuumResources
Control Risks	C/ControlRisks
Converse (part of Nike)	C/ConversepartofNike
Cookson	C/Cookson
Coop (Switzerland)	C/CoopSwitzerland
Coop Norden	C/CoopNorden
Cooper & Co	C/CooperCo
Cooper Industries	C/CooperIndustries
Cooperativa La Cruz Azul	C/CooperativaLaCruzAzul
Coors (see Adolph Coors)	C/CoorsseeAdolphCoors
COPEL (see Companhia Paranaense de Energia)	C/COPELseeCompanhiaParanaensedeEnergia
Coq Sportif	C/CoqSportif
Cora	C/Cora
Corabastos	C/Corabastos
Corel (part of Vector Capital)	C/CorelpartofVectorCapital
Corferias	C/Corferias
Corn Products International	C/CornProductsInternational
Corning	C/Corning
Corporación Moctezuma	C/CorporacinMoctezuma
Corporación Venezolana de Guyana	C/CorporacinVenezolanadeGuyana
Corporativo Moss	C/CorporativoMoss
Correctional Services	C/CorrectionalServices
Corriente Resources	C/CorrienteResources
Cortefiel	C/Cortefiel
Corus Entertainment	C/CorusEntertainment
Corus Group	C/CorusGroup
Cosan Group	C/CosanGroup
Cosco	C/Cosco
Coservicios	C/Coservicios
Cosipar (Companhia Siderurgica do Pará)	C/CosiparCompanhiaSiderurgicadoPar
Cosmo Oil	C/CosmoOil
Cosmos	C/Cosmos
Costa Cruise Lines (part of Carnival)	C/CostaCruiseLinespartofCarnival
Costain	C/Costain
Costco	C/Costco
Cotecna	C/Cotecna
Cotton Group	C/CottonGroup
Coty	C/Coty
Country Garden	C/CountryGarden
Cousins Properties	C/CousinsProperties
Covington & Burling	C/CovingtonBurling
Cox Enterprises	C/CoxEnterprises
CP (Charoen Pokphand)	C/CPCharoenPokphand
Cracker Barrel (part of CBRL Group)	C/CrackerBarrelpartofCBRLGroup
Crane Co.	C/CraneCo
Crate & Barrel	C/CrateBarrel
Cravath Swaine & Moore	C/CravathSwaineMoore
CRDB Bank	C/CRDBBank
Creata	C/Creata
Creative Associates	C/CreativeAssociates
Creative Outsourcing Solutions International (COSi)	C/CreativeOutsourcingSolutionsInternationalCOSi
Cred Jewellery	C/CredJewellery
Crédit Agricole	C/CrditAgricole
Crédit Commercial de France	C/CrditCommercialdeFrance
Crédit du Nord	C/CrditduNord
Crédit Lyonnais (part of Crédit Agricole)	C/CrditLyonnaispartofCrditAgricole
Crédit Mutuel-CIC	C/CrditMutuel-CIC
Credit Suisse	C/CreditSuisse
Crescent Moon Fibers	C/CrescentMoonFibers
Crescent Security Group	C/CrescentSecurityGroup
CRH (Cement Roadstone Holdings)	C/CRHCementRoadstoneHoldings
Cromatos de México (was part of Bayer)	C/CromatosdeMxicowaspartofBayer
Crompton Corporation	C/CromptonCorporation
Crown Hardwood Veneer	C/CrownHardwoodVeneer
Crown Resources	C/CrownResources
Cruz Azul (see Cooperativa La Cruz Azul)	C/CruzAzulseeCooperativaLaCruzAzul
Crystal Cruises (part of NYK Line)	C/CrystalCruisespartofNYKLine
CSFB (see Credit Suisse)	C/CSFBseeCreditSuisse
CSR	C/CSR
CSX	C/CSX
Cubic	C/Cubic
Cumberland Farms	C/CumberlandFarms
Cummins	C/Cummins
Cunard Line (part of Carnival)	C/CunardLinepartofCarnival
Cuno Melcher (part of ME Sportwaffen)	C/CunoMelcherpartofMESportwaffen
Curacao Drydock	C/CuracaoDrydock
Custer Battles	C/CusterBattles
Cutter & Buck	C/CutterBuck
Cutters Gloves (part of Entrix Sports)	C/CuttersGlovespartofEntrixSports
CVRD (see Companhia Vale do Rio Doce)	C/CVRDseeCompanhiaValedoRioDoce
CVS	C/CVS
CWE (see China International Water & Electric)	C/CWEseeChinaInternationalWaterElectric
CWHEC (see Sinohydro)	C/CWHECseeSinohydro
Cytec Industries	C/CytecIndustries
D&S	D/DS
D. Navinchandra	D/DNavinchandra
D1 Oils	D/D1Oils
Dacrea	D/Dacrea
Dada	D/Dada
Daejoo Leports	D/DaejooLeports
Daewoo Electronics	D/DaewooElectronics
Daewoo Group	D/DaewooGroup
Daewoo International	D/DaewooInternational
Daewoo Motor (see GM Daewoo Auto & Technology)	D/DaewooMotorseeGMDaewooAutoTechnology
Dai-Ichi Mutual Life Insurance	D/Dai-IchiMutualLifeInsurance
Daiei	D/Daiei
Daikin	D/Daikin
Daily Mail and General Trust	D/DailyMailandGeneralTrust
Daily Variety (part of Reed Elsevier Group)	D/DailyVarietypartofReedElsevierGroup
DaimlerChrysler	D/DaimlerChrysler
Daishowa-Marubeni	D/Daishowa-Marubeni
Daiwa Securities	D/DaiwaSecurities
Dalhoff Larsen & Horneman (see DLH)	D/DalhoffLarsenHornemanseeDLH
Dana	D/Dana
Danaher	D/Danaher
Daniel Hechter	D/DanielHechter
Daniels Chilled Foods (part of Singapore Food Industries)	D/DanielsChilledFoodspartofSingaporeFoodIndustries
Danisco	D/Danisco
Danone	D/Danone
Danske Bank	D/DanskeBank
Danzer	D/Danzer
Darden Restaurants	D/DardenRestaurants
Das Air Cargo	D/DasAirCargo
Data Device	D/DataDevice
Datang International Power Generation	D/DatangInternationalPowerGeneration
Datong Coal Mine	D/DatongCoalMine
Davis Langdon	D/DavisLangdon
Davivienda	D/Davivienda
Day Chocolate Company	D/DayChocolateCompany
Dayton Hudson (see Target)	D/DaytonHudsonseeTarget
DBS Bank	D/DBSBank
DC Comics (part of Time Warner)	D/DCComicspartofTimeWarner
DCM Shriram	D/DCMShriram
DDC Ireland (part of Data Device)	D/DDCIrelandpartofDataDevice
De Beers	D/DeBeers
De Long Forest Resource	D/DeLongForestResource
Dead Sea Works (part of ICL Fertilizers)	D/DeadSeaWorkspartofICLFertilizers
Dean Foods	D/DeanFoods
Dean's Beans	D/DeansBeans
Debenhams	D/Debenhams
Debswana (joint venture De Beers & Botswana Govt.)	D/DebswanajointventureDeBeersBotswanaGovt
Décathlon	D/Dcathlon
Deceval	D/Deceval
DeCoro	D/DeCoro
DeCoster Farms	D/DeCosterFarms
Deere & Co (see John Deere)	D/DeereCoseeJohnDeere
DeFabCo	D/DeFabCo
Défense Conseil International	D/DfenseConseilInternational
Degussa	D/Degussa
Del Monte Foods	D/DelMonteFoods
Del Monte Fresh Produce (see Fresh Del Monte Produce)	D/DelMonteFreshProduceseeFreshDelMonteProduce
Del Monte Kenya (part of Fresh Del Monte Produce)	D/DelMonteKenyapartofFreshDelMonteProduce
Delhaize	D/Delhaize
Delhi Metro Rail Corporation	D/DelhiMetroRailCorporation
Delixi Group	D/DelixiGroup
Dell	D/Dell
Deloitte Touche Tohmatsu	D/DeloitteToucheTohmatsu
Delphi	D/Delphi
DelSur (part of PPL Corporation)	D/DelSurpartofPPLCorporation
Delta Air Lines	D/DeltaAirLines
Delta and Pine Land	D/DeltaandPineLand
Delta Hess (joint venture Amerada Hess & Delta Oil)	D/DeltaHessjointventureAmeradaHessDeltaOil
Delta Oil	D/DeltaOil
Delta Security Services	D/DeltaSecurityServices
Dena Bank	D/DenaBank
Denel	D/Denel
Denny's	D/Dennys
Denso	D/Denso
Detco Industries	D/DetcoIndustries
Deutsche Bank	D/DeutscheBank
Deutsche Post	D/DeutschePost
Deutsche Telekom	D/DeutscheTelekom
Devanlay	D/Devanlay
Devon Energy	D/DevonEnergy
Dexia	D/Dexia
DFS Furniture	D/DFSFurniture
DGI Group	D/DGIGroup
DHB Industries	D/DHBIndustries
DHL (part of Deutsche Post)	D/DHLpartofDeutschePost
Diadora	D/Diadora
Diagem	D/Diagem
Diageo	D/Diageo
Dial Corp (part of Henkel)	D/DialCorppartofHenkel
Diamond Bank	D/DiamondBank
Diamond Exports	D/DiamondExports
Diamond Offshore Drilling	D/DiamondOffshoreDrilling
Diamond Trading Company (part of De Beers)	D/DiamondTradingCompanypartofDeBeers
Diamond Trust Bank Kenya	D/DiamondTrustBankKenya
DiamondWorks (see Energem Resources)	D/DiamondWorksseeEnergemResources
Diarough	D/Diarough
Diavik (joint venture Rio Tinto & Aber Diamond Mines)	D/DiavikjointventureRioTintoAberDiamondMines
Dick Smith Electronics (part of Woolworths Limited)	D/DickSmithElectronicspartofWoolworthsLimited
Dick Smith Foods	D/DickSmithFoods
Diehl	D/Diehl
Diethelm Keller	D/DiethelmKeller
Dillard Trucking	D/DillardTrucking
Dillard's	D/Dillards
Dimension Data	D/DimensionData
Dinámica IPS	D/DinmicaIPS
Dior	D/Dior
DirecTV	D/DirecTV
Discount Bank	D/DiscountBank
Disney (see Walt Disney)	D/DisneyseeWaltDisney
Disney Cruise Line (part of Walt Disney)	D/DisneyCruiseLinepartofWaltDisney
Distinction Investment Holdings	D/DistinctionInvestmentHoldings
Diversa	D/Diversa
Dixon Ticonderoga	D/DixonTiconderoga
Dixons (part of DSG International)	D/DixonspartofDSGInternational
DKV	D/DKV
DLH (Dalhoff Larsen & Horneman)	D/DLHDalhoffLarsenHorneman
Doba Logistics	D/DobaLogistics
Dodge Company	D/DodgeCompany
Doe Run (part of Renco)	D/DoeRunpartofRenco
Dofasco	D/Dofasco
Dole	D/Dole
Dometic	D/Dometic
Dominion Resources	D/DominionResources
Domino's Pizza	D/DominosPizza
Domtar	D/Domtar
DONG Energy	D/DONGEnergy
Dongfeng Motor	D/DongfengMotor
Dongguan Chaoyue Metal Products	D/DongguanChaoyueMetalProducts
Donna Karan	D/DonnaKaran
Dorsey & Whitney	D/DorseyWhitney
Dow Chemical	D/DowChemical
Dowa	D/Dowa
Downer Edi	D/DownerEdi
DPL	D/DPL
Dr Pepper/Seven Up Bottling Group (owned by Cadbury Schweppes & Carlyle Group)	D/DrPepperSevenUpBottlingGroupownedbyCadburySchweppesCarlyleGroup
Dr. Reddy's Laboratories	D/DrReddysLaboratories
Dr.Hauschka	D/DrHauschka
Dragonair	D/Dragonair
Drax	D/Drax
DRDGold	D/DRDGold
Dresdner Bank (part of Allianz)	D/DresdnerBankpartofAllianz
Dress Barn	D/DressBarn
Dress Confect	D/DressConfect
Dresser-Rand	D/Dresser-Rand
Drew Pearson Marketing (part of Mainland Headwear)	D/DrewPearsonMarketingpartofMainlandHeadwear
Drie Mollen Holding	D/DrieMollenHolding
Drishtee	D/Drishtee
Drummond	D/Drummond
DSM	D/DSM
DTE Energy	D/DTEEnergy
Dubai Contracting	D/DubaiContracting
Duke Energy	D/DukeEnergy
Dumex	D/Dumex
Dunavant	D/Dunavant
Dunkin' Donuts (part of Dunkin' Brands)	D/DunkinDonutspartofDunkinBrands
Dunlop Nigeria	D/DunlopNigeria
DuPont	D/DuPont
Durban Roodepoort Deep (see DRDGold)	D/DurbanRoodepoortDeepseeDRDGold
Dutapalma Nusantara	D/DutapalmaNusantara
DynCorp	D/DynCorp
Éxito	E/xito
E.Land	E/ELand
E.ON	E/EON
E.W. Scripps	E/EWScripps
EADS (European Aeronautic Defence and Space)	E/EADSEuropeanAeronauticDefenceandSpace
Eagle Wings Resources Intl. (joint venture Chemie Pharmacie Holland & Trinitech Holdings)	E/EagleWingsResourcesIntljointventureChemiePharmacieHollandTrinitechHoldings
East African Breweries	E/EastAfricanBreweries
East Asiatic Company	E/EastAsiaticCompany
East Japan Railway	E/EastJapanRailway
Eastman Chemical Company	E/EastmanChemicalCompany
Eastman Kodak	E/EastmanKodak
Eastpak (part of VF Corp)	E/EastpakpartofVFCorp
easyJet	E/easyJet
Eaton	E/Eaton
eBay	E/eBay
EBX	E/EBX
EchoStar Communications	E/EchoStarCommunications
Eckerd	E/Eckerd
ECL (Exploration Consultants Limited)	E/ECLExplorationConsultantsLimited
Eclats Antivols	E/EclatsAntivols
Ecobank	E/Ecobank
EcoCreto	E/EcoCreto
Ecolab	E/Ecolab
Ecology Building Society	E/EcologyBuildingSociety
Ecom Agroindustrial	E/EcomAgroindustrial
Econet Wireless	E/EconetWireless
Econo Lodge (part of Choice Hotels)	E/EconoLodgepartofChoiceHotels
Economax (parte de Cencosud)	E/EconomaxpartedeCencosud
Ecopetrol	E/Ecopetrol
Ecover	E/Ecover
Ecuacorriente (part of Corriente Resources)	E/EcuacorrientepartofCorrienteResources
Ecuavital Biox	E/EcuavitalBiox
ED&F Man	E/EDFMan
Edcon	E/Edcon
Eddie Bauer	E/EddieBauer
Edelman	E/Edelman
Eden Springs	E/EdenSprings
Edenor	E/Edenor
EDF	E/EDF
Edgars Consolidated (see Edcon)	E/EdgarsConsolidatedseeEdcon
Edison (Italy)	E/EdisonItaly
Edison International	E/EdisonInternational
Edun	E/Edun
eHarmony	E/eHarmony
El Corte Inglés	E/ElCorteIngls
El Monte	E/ElMonte
El Mundo (part of Unidad Editorial)	E/ElMundopartofUnidadEditorial
El País (part of Grupo Prisa)	E/ElPaspartofGrupoPrisa
El Paso Energy	E/ElPasoEnergy
El Salam Maritime	E/ElSalamMaritime
Elan	E/Elan
Elbit Systems	E/ElbitSystems
Elderwear	E/Elderwear
Electrabel	E/Electrabel
Electricité et Eaux de Madagascar	E/ElectricitetEauxdeMadagascar
Electricity Generating Public Company	E/ElectricityGeneratingPublicCompany
Electrolux	E/Electrolux
Electronic Data Systems	E/ElectronicDataSystems
Elektra	E/Elektra
Elementis	E/Elementis
Elettronica Aster	E/ElettronicaAster
Elf Aquitaine (now part of Total)	E/ElfAquitainenowpartofTotal
Eli Lilly	E/EliLilly
Elkraft System	E/ElkraftSystem
Emap	E/Emap
Emaxon (part of DGI Group)	E/EmaxonpartofDGIGroup
EMC	E/EMC
Emcure	E/Emcure
Emergent Genetics (part of Monsanto)	E/EmergentGeneticspartofMonsanto
Emerson Electric	E/EmersonElectric
EMI	E/EMI
Emirates (part of Emirates Group)	E/EmiratespartofEmiratesGroup
Emirates Group	E/EmiratesGroup
Emperor	E/Emperor
Emperor Mines	E/EmperorMines
Emporio Armani (part of Giorgio Armani)	E/EmporioArmanipartofGiorgioArmani
Empresas CMPC	E/EmpresasCMPC
Enagás	E/Enags
Enap	E/Enap
Enbridge	E/Enbridge
EnCana	E/EnCana
ENCE	E/ENCE
Endeavour Resources	E/EndeavourResources
Endesa	E/Endesa
Endiama (Empresa Nacional de Diamantes de Angola)	E/EndiamaEmpresaNacionaldeDiamantesdeAngola
Enel	E/Enel
Energem Resources	E/EnergemResources
Energi Mega Persada	E/EnergiMegaPersada
Energie Baden-Wuerttemberg (EnBW)	E/EnergieBaden-WuerttembergEnBW
Energizer	E/Energizer
Energy Northwest	E/EnergyNorthwest
Energy Resources Australia (part of Rio Tinto)	E/EnergyResourcesAustraliapartofRioTinto
Engelhard (part of BASF)	E/EngelhardpartofBASF
Engen (part of Petronas)	E/EngenpartofPetronas
Engineers India	E/EngineersIndia
ENI	E/ENI
Enron	E/Enron
Entergy	E/Entergy
Enterprise Inns	E/EnterpriseInns
Enterprise Products	E/EnterpriseProducts
Enterprise Rent-A-Car	E/EnterpriseRent-A-Car
Entre Mares (part of Goldcorp)	E/EntreMarespartofGoldcorp
Entrix Sports	E/EntrixSports
Entrx	E/Entrx
Environnement SA	E/EnvironnementSA
EOD Technology	E/EODTechnology
EOG Resources	E/EOGResources
Epic Resins	E/EpicResins
EPM (Empresas Públicas de Medellín)	E/EPMEmpresasPblicasdeMedelln
Epson (part of Seiko)	E/EpsonpartofSeiko
Equals International	E/EqualsInternational
Equilon (part of Shell)	E/EquilonpartofShell
Equity Bank	E/EquityBank
Equity Building Society (see Equity Bank)	E/EquityBuildingSocietyseeEquityBank
ERHC (Environmental Remediation Holding Corporation)	E/ERHCEnvironmentalRemediationHoldingCorporation
Ericsson	E/Ericsson
Erinys International	E/ErinysInternational
Ernest Jones (part of Signet)	E/ErnestJonespartofSignet
Ernst & Young	E/ErnstYoung
Eroski	E/Eroski
Ersol Solar Energy	E/ErsolSolarEnergy
Erste Bank der Oesterreichischen Sparkassen	E/ErsteBankderOesterreichischenSparkassen
Eskom	E/Eskom
Esmeralda Exploration	E/EsmeraldaExploration
Esprit	E/Esprit
Esquel	E/Esquel
ESRI	E/ESRI
ESS Chemicals	E/ESSChemicals
Essar Group	E/EssarGroup
Essilor	E/Essilor
Esso (part of ExxonMobil)	E/EssopartofExxonMobil
Estarta Solutions	E/EstartaSolutions
Estée Lauder	E/EsteLauder
Ethiopian Airlines	E/EthiopianAirlines
Ethyl (part of NewMarket)	E/EthylpartofNewMarket
Etienne Aigner	E/EtienneAigner
Etisalat	E/Etisalat
Eugene Perma	E/EugenePerma
Eurocare Environmental Services	E/EurocareEnvironmentalServices
Eurocopter (part of EADS)	E/EurocopterpartofEADS
European Metal Recycling	E/EuropeanMetalRecycling
Eutelsat	E/Eutelsat
EVA Airways	E/EVAAirways
Everfresh (part of Fyffes)	E/EverfreshpartofFyffes
Evergreen America (part of Evergreen Group)	E/EvergreenAmericapartofEvergreenGroup
Evergreen Group	E/EvergreenGroup
Evergreen Marine (part of Evergreen Group)	E/EvergreenMarinepartofEvergreenGroup
Everite	E/Everite
Evraz	E/Evraz
Executive Outcomes	E/ExecutiveOutcomes
Exel (part of Deutsche Post)	E/ExelpartofDeutschePost
Exelon	E/Exelon
EXMIBAL	E/EXMIBAL
Expedia	E/Expedia
Express Manufacturing	E/ExpressManufacturing
Expro	E/Expro
Exxaro	E/Exxaro
Exxon Neftegas (part of ExxonMobil)	E/ExxonNeftegaspartofExxonMobil
ExxonMobil	E/ExxonMobil
Eziba	E/Eziba
Faber-Castell	F/Faber-Castell
Fabricato-Tejicóndor	F/Fabricato-Tejicndor
Faegre & Benson	F/FaegreBenson
Fairchild Semiconductor	F/FairchildSemiconductor
Fairfax Financial Holdings	F/FairfaxFinancialHoldings
Fairmont Hotels & Resorts	F/FairmontHotelsResorts
Fairwood	F/Fairwood
Faisal Islamic Bank	F/FaisalIslamicBank
Falabella	F/Falabella
Falconbridge (now part of Xstrata)	F/FalconbridgenowpartofXstrata
Family Dollar	F/FamilyDollar
Fanalca	F/Fanalca
Fanhai Group	F/FanhaiGroup
Fannie Mae	F/FannieMae
Farmacia San Martín	F/FarmaciaSanMartn
FAST	F/FAST
Fastlink	F/Fastlink
Favorita Fruit Company	F/FavoritaFruitCompany
FC Barcelona	F/FCBarcelona
FCC	F/FCC
Federal-Mogul	F/Federal-Mogul
Federated Department Stores	F/FederatedDepartmentStores
FedEx	F/FedEx
FedEx Kinko's (part of FedEx)	F/FedExKinkospartofFedEx
Feldmeyer (see Hinrich Feldmeyer)	F/FeldmeyerseeHinrichFeldmeyer
FEMSA	F/FEMSA
Ferro Corporation	F/FerroCorporation
Ferrovial	F/Ferrovial
Fertiberia	F/Fertiberia
Feza Pharmaceuticals (joint venture Creative Solutions International & African Healthcare Solutions)	F/FezaPharmaceuticalsjointventureCreativeSolutionsInternationalAfricanHealthcareSolutions
FFS Refiners	F/FFSRefiners
Fiat	F/Fiat
Fibres & Fabrics International (FFI)	F/FibresFabricsInternationalFFI
Fidelity Investments	F/FidelityInvestments
Fifth Third Bank	F/FifthThirdBank
Fila (part of Sport Brands International)	F/FilapartofSportBrandsInternational
Financiera Independencia	F/FinancieraIndependencia
Fineco	F/Fineco
Finlay Fine Jewelry	F/FinlayFineJewelry
Finmeccanica	F/Finmeccanica
Finning	F/Finning
Fire Mountain Gems	F/FireMountainGems
Fireman's Fund (part of Allianz)	F/FiremansFundpartofAllianz
Firestone (see Bridgestone-Firestone)	F/FirestoneseeBridgestone-Firestone
First American Bank of Kenya (part of Sameer Group)	F/FirstAmericanBankofKenyapartofSameerGroup
First Asia Finance	F/FirstAsiaFinance
First Choice Holidays	F/FirstChoiceHolidays
First Data	F/FirstData
First Kuwaiti	F/FirstKuwaiti
First National Bank [So. Africa] (part of FirstRand)	F/FirstNationalBankSoAfricapartofFirstRand
First Quantum Minerals	F/FirstQuantumMinerals
First Trust Bank (part of Allied Irish Banks)	F/FirstTrustBankpartofAlliedIrishBanks
First Women Bank	F/FirstWomenBank
First Years (part of RC2)	F/FirstYearspartofRC2
FirstEnergy	F/FirstEnergy
FirstGroup	F/FirstGroup
FirstRand Group	F/FirstRandGroup
Fisher-Price (part of Mattel)	F/Fisher-PricepartofMattel
Fitzner	F/Fitzner
Flamingo Holdings	F/FlamingoHoldings
Fleet (part of Bank of America)	F/FleetpartofBankofAmerica
Flexim	F/Flexim
Flextronics	F/Flextronics
Flint Hills Resources (part of Koch Industries)	F/FlintHillsResourcespartofKochIndustries
Florida Crystals	F/FloridaCrystals
Florida Power & Light (part of FPL Group)	F/FloridaPowerLightpartofFPLGroup
FLS Industries	F/FLSIndustries
Fluor	F/Fluor
Flying Crane	F/FlyingCrane
FM Global	F/FMGlobal
FN Herstal	F/FNHerstal
Fnac (part of Pinault-Printemps-Redoute)	F/FnacpartofPinault-Printemps-Redoute
Fodors (part of Random House)	F/FodorspartofRandomHouse
Folgers (part of Procter & Gamble)	F/FolgerspartofProcterGamble
Folksam	F/Folksam
Foncia	F/Foncia
Fonterra	F/Fonterra
Food Lion (part of Delhaize)	F/FoodLionpartofDelhaize
Foodstuffs	F/Foodstuffs
Foot Locker	F/FootLocker
Forbes Marshall	F/ForbesMarshall
Ford	F/Ford
"Ford, Bacon & Davis"	F/FordBaconDavis
Forest Laboratories	F/ForestLaboratories
Forestal Bío Bío	F/ForestalBoBo
ForesTrade	F/ForesTrade
Forges de Zeebrugge (part of Thales)	F/ForgesdeZeebruggepartofThales
Formosa Plastics	F/FormosaPlastics
Forrest Group (see George Forrest)	F/ForrestGroupseeGeorgeForrest
Fortinet	F/Fortinet
Fortis	F/Fortis
Fortum	F/Fortum
Fortunoff	F/Fortunoff
Forza	F/Forza
Foschini	F/Foschini
Foskor	F/Foskor
Foster's	F/Fosters
Fosun	F/Fosun
Foundation Coal	F/FoundationCoal
Fountain Set (Holdings)	F/FountainSetHoldings
Four Seasons Hotels	F/FourSeasonsHotels
Fox Entertainment (part of News Corporation)	F/FoxEntertainmentpartofNewsCorporation
Foxconn (part of Hon Hai)	F/FoxconnpartofHonHai
FP Corporation	F/FPCorporation
FPL Group	F/FPLGroup
FPT Industries (part of GKN)	F/FPTIndustriespartofGKN
France Telecom	F/FranceTelecom
Franklin Mint	F/FranklinMint
Franklin Sports	F/FranklinSports
Fred Meyer Jewelers (part of Kroger)	F/FredMeyerJewelerspartofKroger
Fred's	F/Freds
Freddie Mac	F/FreddieMac
Frederick's of Hollywood	F/FredericksofHollywood
Freeport Indonesia (part of Freeport-McMoRan)	F/FreeportIndonesiapartofFreeport-McMoRan
Freeport-McMoRan	F/Freeport-McMoRan
Freescale Semiconductor	F/FreescaleSemiconductor
French Connection	F/FrenchConnection
Fresenius Medical Care	F/FreseniusMedicalCare
Fresh Del Monte Produce	F/FreshDelMonteProduce
Freshfields Bruckhaus Deringer	F/FreshfieldsBruckhausDeringer
Freudenberg	F/Freudenberg
Freudenberg-NOK (joint venture Freudenberg & NOK)	F/Freudenberg-NOKjointventureFreudenbergNOK
Friedman's	F/Friedmans
Friends Provident	F/FriendsProvident
Friesland Coberco	F/FrieslandCoberco
Frigidaire (part of Electrolux)	F/FrigidairepartofElectrolux
Friosur	F/Friosur
Frito-Lay (part of PepsiCo)	F/Frito-LaypartofPepsiCo
Fritz Werner Company	F/FritzWernerCompany
Frontera Resources	F/FronteraResources
Fruit of the Loom (part of Berkshire Hathaway)	F/FruitoftheLoompartofBerkshireHathaway
Fuji Heavy Industries	F/FujiHeavyIndustries
Fuji Photo Film	F/FujiPhotoFilm
Fuji Xerox (joint venture Fuji Photo Film & Xerox)	F/FujiXeroxjointventureFujiPhotoFilmXerox
Fujitsu	F/Fujitsu
Fujitsu Siemens (joint venture Fujitsu & Siemens)	F/FujitsuSiemensjointventureFujitsuSiemens
Fulbond	F/Fulbond
Furukawa	F/Furukawa
Future Factory	F/FutureFactory
Fuyao Group	F/FuyaoGroup
Fuyuan Holdings	F/FuyuanHoldings
Fyffes	F/Fyffes
FZ (see Forges de Zeebrugge)	F/FZseeForgesdeZeebrugge
G2000	G/G2000
Gaastra (part of McGregor Fashion)	G/GaastrapartofMcGregorFashion
GAB Robins	G/GABRobins
GABA	G/GABA
Gabriel Resources	G/GabrielResources
Gage Products	G/GageProducts
GAIL (Gas Authority of India Ltd.)	G/GAILGasAuthorityofIndiaLtd
Galana Petroleum	G/GalanaPetroleum
Galanz	G/Galanz
Galeries Lafayette	G/GaleriesLafayette
Gallaher	G/Gallaher
Gama	G/Gama
Gamesa	G/Gamesa
Gamma Holding	G/GammaHolding
Gannett	G/Gannett
Gansu Yasheng Industrial	G/GansuYashengIndustrial
GanZhou Cobalt & Tungsten	G/GanZhouCobaltTungsten
Gap	G/Gap
GardaWorld	G/GardaWorld
Gargiulo	G/Gargiulo
Garnier (part of L'Oreal)	G/GarnierpartofLOreal
Garuda Indonesia	G/GarudaIndonesia
Gas Authority of India Ltd. (see GAIL)	G/GasAuthorityofIndiaLtdseeGAIL
Gas Jeans (part of Grotto)	G/GasJeanspartofGrotto
Gas Natural	G/GasNatural
Gates	G/Gates
Gateway	G/Gateway
Gauff Ingenieure	G/GauffIngenieure
Gaz de France	G/GazdeFrance
Gazprom	G/Gazprom
GE (see General Electric)	G/GEseeGeneralElectric
GEAR for Sports	G/GEARforSports
Gécamines	G/Gcamines
GEICO (part of Berkshire Hathaway)	G/GEICOpartofBerkshireHathaway
Gelmart Industries	G/GelmartIndustries
Gemesis	G/Gemesis
Gencor (mining)	G/Gencormining
Genentech	G/Genentech
General Atomics	G/GeneralAtomics
General Dynamics	G/GeneralDynamics
General Electric	G/GeneralElectric
General Mills	G/GeneralMills
General Motors	G/GeneralMotors
Genmab	G/Genmab
Geometric Power Limited	G/GeometricPowerLimited
George Forrest	G/GeorgeForrest
George Wimpey	G/GeorgeWimpey
Georgia Power (part of Southern Company)	G/GeorgiaPowerpartofSouthernCompany
Georgia-Pacific (part of Koch Industries)	G/Georgia-PacificpartofKochIndustries
Georgian International Oil	G/GeorgianInternationalOil
GEPetrol	G/GEPetrol
Gerber	G/Gerber
Gerdau	G/Gerdau
Gerling Group	G/GerlingGroup
GFI Manpower	G/GFIManpower
Ghana Manganese	G/GhanaManganese
Ghana Telecom	G/GhanaTelecom
Ghella	G/Ghella
Giant Food (part of Ahold)	G/GiantFoodpartofAhold
Giat (now Nexter)	G/GiatnowNexter
Gibson	G/Gibson
Gildan Activewear	G/GildanActivewear
Gilead Sciences	G/GileadSciences
Gillette (part of Procter & Gamble)	G/GillettepartofProcterGamble
Gilster-Mary Lee	G/Gilster-MaryLee
Gina Form	G/GinaForm
Giorgio Armani	G/GiorgioArmani
Giumarra	G/Giumarra
GKN	G/GKN
Glamis Gold (part of Goldcorp)	G/GlamisGoldpartofGoldcorp
GlaxoSmithKline	G/GlaxoSmithKline
Glebe	G/Glebe
Glencore	G/Glencore
Global Accessories	G/GlobalAccessories
Global Research Technologies	G/GlobalResearchTechnologies
Global Sources	G/GlobalSources
Global Sports Lanka - GSL (part of GST)	G/GlobalSportsLanka-GSLpartofGST
GM Daewoo Auto & Technology	G/GMDaewooAutoTechnology
GMAC (part of General Motors)	G/GMACpartofGeneralMotors
GMP Capital	G/GMPCapital
Go Daddy	G/GoDaddy
Goddard Enterprises	G/GoddardEnterprises
Godrej & Boyce	G/GodrejBoyce
Gokaldas Exports	G/GokaldasExports
Gold Fields	G/GoldFields
Gold Peak	G/GoldPeak
Goldcorp	G/Goldcorp
Golden Star Resources	G/GoldenStarResources
Goldlion	G/Goldlion
Goldman Sachs	G/GoldmanSachs
Goldshield	G/Goldshield
Gome	G/Gome
Goodrich	G/Goodrich
Goodricke	G/Goodricke
Goodyear	G/Goodyear
Google	G/Google
Gossypium	G/Gossypium
GP Batteries (part of Gold Peak)	G/GPBatteriespartofGoldPeak
GraceKennedy	G/GraceKennedy
Graham & Brown	G/GrahamBrown
Grameen Bank	G/GrameenBank
Grana y Montero	G/GranayMontero
GRD	G/GRD
Great Lakes Chemical	G/GreatLakesChemical
Great North Eastern Railway	G/GreatNorthEasternRailway
Great Plains Energy	G/GreatPlainsEnergy
Great Provider Service Exports	G/GreatProviderServiceExports
Great White Fleet (part of Chiquita)	G/GreatWhiteFleetpartofChiquita
Greater Nile Petroleum Operating Company (GNPOC)	G/GreaterNilePetroleumOperatingCompanyGNPOC
Green & Black's (part of Cadbury-Schweppes)	G/GreenBlackspartofCadbury-Schweppes
Green Mountain Coffee	G/GreenMountainCoffee
Green-Tech Assets	G/Green-TechAssets
Greenstone Resources	G/GreenstoneResources
Greggs	G/Greggs
Greystar Resources	G/GreystarResources
Greystone	G/Greystone
Griffin Land & Nurseries	G/GriffinLandNurseries
Grindrod	G/Grindrod
Grintek	G/Grintek
Groom Law	G/GroomLaw
Group 4 (part of Group 4 Securicor)	G/Group4partofGroup4Securicor
Group 4 Falck (see Group 4 Securicor)	G/Group4FalckseeGroup4Securicor
Group 4 Securicor	G/Group4Securicor
Group Five	G/GroupFive
Groupama	G/Groupama
Groupe Banque Populaire	G/GroupeBanquePopulaire
Grundig	G/Grundig
Grünenthal	G/Grnenthal
Grupo ACS	G/GrupoACS
Grupo Alfonso Gallardo	G/GrupoAlfonsoGallardo
Grupo André Maggi	G/GrupoAndrMaggi
Grupo Calvo	G/GrupoCalvo
Grupo Carso	G/GrupoCarso
Grupo Cementos de Chihuahua	G/GrupoCementosdeChihuahua
Grupo Financiero Banamex (see Banamex)	G/GrupoFinancieroBanamexseeBanamex
Grupo Hiemesa	G/GrupoHiemesa
Grupo Lajat	G/GrupoLajat
Grupo Logístico Andreani	G/GrupoLogsticoAndreani
Grupo M	G/GrupoM
Grupo México	G/GrupoMxico
Grupo Modelo	G/GrupoModelo
Grupo Nueva	G/GrupoNueva
Grupo Obrascon Huarte Lain (see Grupo OHL)	G/GrupoObrasconHuarteLainseeGrupoOHL
Grupo OHL	G/GrupoOHL
Grupo Orsa	G/GrupoOrsa
Grupo Perc	G/GrupoPerc
Grupo Planeta	G/GrupoPlaneta
Grupo Prisa	G/GrupoPrisa
Grupo Sacyr Vallehermoso	G/GrupoSacyrVallehermoso
Grupo Tomza	G/GrupoTomza
Grupo VIPS	G/GrupoVIPS
GSL (Global Solutions Ltd)	G/GSLGlobalSolutionsLtd
GSL Australia (part of GSL)	G/GSLAustraliapartofGSL
GST (Global Sports Technologies)	G/GSTGlobalSportsTechnologies
Guangdong Bioyee Pharmaceutical	G/GuangdongBioyeePharmaceutical
"Guangdong Red Bay Generation (joint venture Guangzhou Development Industry Holdings, Guangdong Yudean Group, Guangdong Electric Power Development)"	G/GuangdongRedBayGenerationjointventureGuangzhouDevelopmentIndustryHoldingsGuangdongYudeanGroupGuangdongElectricPowerDevelopment
Guangdong Yudean Group	G/GuangdongYudeanGroup
Guangsha Group	G/GuangshaGroup
Guangzhou Hoton Chemical	G/GuangzhouHotonChemical
Guangzhou Huasheng	G/GuangzhouHuasheng
Guardian Holdings	G/GuardianHoldings
Guardian Industries	G/GuardianIndustries
Guardian Media	G/GuardianMedia
Gucci (part of Pinault-Printemps-Redoute)	G/GuccipartofPinault-Printemps-Redoute
Guess	G/Guess
Guilin Pharmaceutical	G/GuilinPharmaceutical
Guinness (part of Diageo)	G/GuinnesspartofDiageo
Guittard	G/Guittard
Guizhou CLP Power (part of CLP Holdings)	G/GuizhouCLPPowerpartofCLPHoldings
Guizhou Red Star Developing Company (part of Qingdao Red Star Chemical Group)	G/GuizhouRedStarDevelopingCompanypartofQingdaoRedStarChemicalGroup
Guizhou Zhongshui Energy Development	G/GuizhouZhongshuiEnergyDevelopment
Gujarat Ambuja Cements	G/GujaratAmbujaCements
Gujarat Fluorochemicals	G/GujaratFluorochemicals
Gulf Electric	G/GulfElectric
Gulf Oil	G/GulfOil
Gunma Bank	G/GunmaBank
Gunns	G/Gunns
Guru Sportswear	G/GuruSportswear
GUS	G/GUS
GWR Group	G/GWRGroup
Gymboree	G/Gymboree
H&M	H/HM
H. J. Heinz (see Heinz)	H/HJHeinzseeHeinz
H.Samuel (part of Signet)	H/HSamuelpartofSignet
Haco Industries	H/HacoIndustries
Hafslund	H/Hafslund
Hagemeyer	H/Hagemeyer
Haggar	H/Haggar
Haier	H/Haier
Haifa Chemicals (part of Trans-Resources)	H/HaifaChemicalspartofTrans-Resources
Haitian American Apparel	H/HaitianAmericanApparel
Halliburton	H/Halliburton
Hallmark Cards	H/HallmarkCards
Halsall	H/Halsall
Hamleys	H/Hamleys
Hammerson	H/Hammerson
Hana Microelectronics	H/HanaMicroelectronics
Hanes (part of Hanesbrands)	H/HanespartofHanesbrands
Hanesbrands	H/Hanesbrands
Hang Seng Bank	H/HangSengBank
Hanjin Group	H/HanjinGroup
Hanjin Shipping (part of Hanjin Group)	H/HanjinShippingpartofHanjinGroup
Hankook Tire	H/HankookTire
Hanover Insurance	H/HanoverInsurance
Haoyuan Chemical	H/HaoyuanChemical
Hapag-Lloyd Group	H/Hapag-LloydGroup
Harbin Dongan Engine	H/HarbinDonganEngine
Harbin Power Engineering (HPE) (part of Harbin Power Equipment)	H/HarbinPowerEngineeringHPEpartofHarbinPowerEquipment
Harbin Yilan Zhongtai Chemical	H/HarbinYilanZhongtaiChemical
Harcros Chemicals	H/HarcrosChemicals
Hardee's (part of CKE Restaurants)	H/HardeespartofCKERestaurants
Harf Information Technology	H/HarfInformationTechnology
Harley-Davidson	H/Harley-Davidson
Harleysville Insurance	H/HarleysvilleInsurance
Harmony Gold	H/HarmonyGold
Harrah's	H/Harrahs
Harris Farms	H/HarrisFarms
Harris Ranch (see Harris Farms)	H/HarrisRanchseeHarrisFarms
Harrods	H/Harrods
Harry Winston (part of Aber Diamond)	H/HarryWinstonpartofAberDiamond
Hart Group	H/HartGroup
Hartford Financial Services	H/HartfordFinancialServices
Hartford Steam Boiler (part of AIG)	H/HartfordSteamBoilerpartofAIG
Hartmann	H/Hartmann
Harvest Rich	H/HarvestRich
Harvey Norman	H/HarveyNorman
Hasbro	H/Hasbro
Hashimoto Trading	H/HashimotoTrading
Hashmira (part of Group 4 Securicor)	H/HashmirapartofGroup4Securicor
Havas	H/Havas
Hay Group	H/HayGroup
Hayleys Group	H/HayleysGroup
Hays	H/Hays
Hazama	H/Hazama
HBO (part of Time Warner)	H/HBOpartofTimeWarner
HBOS	H/HBOS
HDFC	H/HDFC
Health Care Service	H/HealthCareService
Heartland Industrial Partners	H/HeartlandIndustrialPartners
Heathgate Resources (part of General Atomics)	H/HeathgateResourcespartofGeneralAtomics
Heckler and Koch	H/HecklerandKoch
HeidelbergCement	H/HeidelbergCement
Heidelberger Druckmaschinen	H/HeidelbergerDruckmaschinen
Heineken	H/Heineken
Heinz	H/Heinz
Helados Holanda (part of Unilever)	H/HeladosHolandapartofUnilever
Helisota	H/Helisota
Hellen Greathouse	H/HellenGreathouse
Hellenic Telecommunication Organisation (see OTE)	H/HellenicTelecommunicationOrganisationseeOTE
Heller Ehrman	H/HellerEhrman
Helly Hansen	H/HellyHansen
Helzberg Diamonds (part of Berkshire Hathaway)	H/HelzbergDiamondspartofBerkshireHathaway
Hemus	H/Hemus
Henan Rebecca	H/HenanRebecca
Henderson Global Investors (part of AMP Group)	H/HendersonGlobalInvestorspartofAMPGroup
Henderson Land	H/HendersonLand
Hengda Group	H/HengdaGroup
Hengquan Cosmetics	H/HengquanCosmetics
Henkel	H/Henkel
Hennes & Mauritz (see H&M)	H/HennesMauritzseeHM
Herbert Smith	H/HerbertSmith
Hercules	H/Hercules
Herff Jones	H/HerffJones
Herman Miller	H/HermanMiller
Hermès	H/Herms
Hero Honda	H/HeroHonda
Hershey	H/Hershey
Hess Corporation	H/HessCorporation
Hetero	H/Hetero
Hetman	H/Hetman
Hewitt Associates	H/HewittAssociates
Hewlett-Packard (see HP)	H/Hewlett-PackardseeHP
Hiatts	H/Hiatts
Hierros del Mediterráneo (parte de Grupo Hiemesa)	H/HierrosdelMediterrneopartedeGrupoHiemesa
Hifn	H/Hifn
Highlands Pacific	H/HighlandsPacific
Highveld Steel & Vanadium (part of Anglo American)	H/HighveldSteelVanadiumpartofAngloAmerican
Hilton Group (now Ladbrokes)	H/HiltonGroupnowLadbrokes
Hilton Hotels	H/HiltonHotels
Hindalco (part of Aditya Birla Group)	H/HindalcopartofAdityaBirlaGroup
Hindustan Aeronautics	H/HindustanAeronautics
Hindustan Lever (part of Unilever)	H/HindustanLeverpartofUnilever
Hindustan Paper Corporation	H/HindustanPaperCorporation
Hindustan Petroleum	H/HindustanPetroleum
Hino	H/Hino
Hinrich Feldmeyer	H/HinrichFeldmeyer
Hipermercado Libertad	H/HipermercadoLibertad
Hipp	H/Hipp
Hirtenberger	H/Hirtenberger
HIT Entertainment	H/HITEntertainment
Hitachi	H/Hitachi
Hitchins	H/Hitchins
Hocol (part of Maurel & Prom)	H/HocolpartofMaurelProm
Hoffman-La Roche (part of Roche)	H/Hoffman-LaRochepartofRoche
Holcim	H/Holcim
Holcim Apasco (part of Holcim)	H/HolcimApascopartofHolcim
Holding Redlich	H/HoldingRedlich
Holiday Inn (part of InterContinental Hotels)	H/HolidayInnpartofInterContinentalHotels
Holland & Knight	H/HollandKnight
Holland America Line (part of Carnival)	H/HollandAmericaLinepartofCarnival
Holmen	H/Holmen
Home Depot	H/HomeDepot
Home Retail Group	H/HomeRetailGroup
Homebase (part of Home Retail Group)	H/HomebasepartofHomeRetailGroup
Homegrown Kenya (part of Flamingo Holdings)	H/HomegrownKenyapartofFlamingoHoldings
Hon Hai	H/HonHai
Honda	H/Honda
Honeywell	H/Honeywell
Hong Kong Electric	H/HongKongElectric
Hong Kong International Airport	H/HongKongInternationalAirport
Hongkong Tramways	H/HongkongTramways
Hongqingting Group	H/HongqingtingGroup
Hooters	H/Hooters
Hopson Development	H/HopsonDevelopment
Horizon Organic	H/HorizonOrganic
Hospira	H/Hospira
Hotel Lotte	H/HotelLotte
House of Fraser	H/HouseofFraser
HP (Hewlett-Packard)	H/HPHewlett-Packard
HSBC	H/HSBC
Huaneng Power International	H/HuanengPowerInternational
Huapont Pharm	H/HuapontPharm
Huashang Clothing (see Shanghai Huashang Clothing)	H/HuashangClothingseeShanghaiHuashangClothing
Huatai	H/Huatai
Huawei Technologies	H/HuaweiTechnologies
Hudson's Bay	H/HudsonsBay
Hug	H/Hug
Hugo Boss	H/HugoBoss
Humana	H/Humana
Hunan Hydropower Design Institute	H/HunanHydropowerDesignInstitute
Hunan Zhuzhou Chemical Industry	H/HunanZhuzhouChemicalIndustry
Hung Hing Printing	H/HungHingPrinting
Hunt Oil	H/HuntOil
Hunter Douglas	H/HunterDouglas
Hunter Hall Investment Management	H/HunterHallInvestmentManagement
Hunton & Williams	H/HuntonWilliams
Huntsman	H/Huntsman
Hutchison Whampoa	H/HutchisonWhampoa
HVA International	H/HVAInternational
HVB	H/HVB
Hyatt	H/Hyatt
Hydro (see Norsk Hydro)	H/HydroseeNorskHydro
Hydro-Québec	H/Hydro-Qubec
Hydrobudowa (part of NCC)	H/HydrobudowapartofNCC
Hyosung	H/Hyosung
Hyperion Solutions	H/HyperionSolutions
Hypovereinsbank (see HVB)	H/HypovereinsbankseeHVB
Hyundai Asan (part of Hyundai Group)	H/HyundaiAsanpartofHyundaiGroup
Hyundai Corporation (part of Hyundai Group)	H/HyundaiCorporationpartofHyundaiGroup
Hyundai Group	H/HyundaiGroup
Hyundai Kia Motor	H/HyundaiKiaMotor
Hyundai Motor (part of Hyundai Kia Motor)	H/HyundaiMotorpartofHyundaiKiaMotor
IAB Industries Lindarbeitsschu	I/IABIndustriesLindarbeitsschu
IamGold	I/IamGold
Iberdrola	I/Iberdrola
Iberia	I/Iberia
IBM	I/IBM
ICA (part of Ahold)	I/ICApartofAhold
ICAP	I/ICAP
Iceland (part of the Big Food Group)	I/IcelandpartoftheBigFoodGroup
ICI	I/ICI
ICICI	I/ICICI
ICL Fertilizers	I/ICLFertilizers
ICL Plastics	I/ICLPlastics
iEnergizer	I/iEnergizer
IGB Corporation Berhad	I/IGBCorporationBerhad
IHC Caland	I/IHCCaland
IKEA	I/IKEA
IKON	I/IKON
Illinois Tool Works	I/IllinoisToolWorks
Impala Platinum	I/ImpalaPlatinum
Imperial Nurseries (part of Griffin Land & Nurseries)	I/ImperialNurseriespartofGriffinLandNurseries
Imperial Oil	I/ImperialOil
Imperial Tobacco	I/ImperialTobacco
Implats (see Impala Platinum)	I/ImplatsseeImpalaPlatinum
Impsat	I/Impsat
InBev	I/InBev
Inco (part of Companhia Vale do Rio Doce)	I/IncopartofCompanhiaValedoRioDoce
"Indal (Indian Aluminium, part of Aditya Birla Group)"	I/IndalIndianAluminiumpartofAdityaBirlaGroup
Indian Airlines	I/IndianAirlines
Indian Farmers Fertiliser Cooperative	I/IndianFarmersFertiliserCooperative
Indian Oil Corporation	I/IndianOilCorporation
Indian Railways	I/IndianRailways
Inditex	I/Inditex
Indo Gulf Fertilisers (part of Aditya Birla Group)	I/IndoGulfFertiliserspartofAdityaBirlaGroup
Indocement (part of Heidelberg Cement)	I/IndocementpartofHeidelbergCement
Indra	I/Indra
Indupalma	I/Indupalma
Indusparquet	I/Indusparquet
Industria de Turbo Propulsores (see ITP Group)	I/IndustriadeTurboPropulsoresseeITPGroup
Industrial Bank	I/IndustrialBank
Industrial Investors (see Prominvestors)	I/IndustrialInvestorsseeProminvestors
Industrial Minera México (part of Grupo México)	I/IndustrialMineraMxicopartofGrupoMxico
Induyco (part of El Corte Inglés)	I/InduycopartofElCorteIngls
Ineos Chlor	I/IneosChlor
Inetol Headwear	I/InetolHeadwear
Infinity	I/Infinity
Infosys	I/Infosys
Infra	I/Infra
ING	I/ING
ING Australia (joint venture ING & ANZ Bank)	I/INGAustraliajointventureINGANZBank
Ingalls (part of Northrop Grumman)	I/IngallspartofNorthropGrumman
Ingenio La Cabaña	I/IngenioLaCabaa
Ingenio San Francisco	I/IngenioSanFrancisco
Ingersoll-Rand	I/Ingersoll-Rand
Inland Printing	I/InlandPrinting
Inmet Mining	I/InmetMining
Innophos	I/Innophos
INPEX	I/INPEX
Insurance Australia Group	I/InsuranceAustraliaGroup
Integrated Technology Group	I/IntegratedTechnologyGroup
Intel	I/Intel
Interamerican Coal	I/InteramericanCoal
Interbar Gloves	I/InterbarGloves
Interbrew (now InBev)	I/InterbrewnowInBev
Intercell	I/Intercell
Intercon Security	I/InterconSecurity
Interconexión Eléctrica (part of ISA Group)	I/InterconexinElctricapartofISAGroup
Intercontinental Hardwoods	I/IntercontinentalHardwoods
InterContinental Hotels	I/InterContinentalHotels
Interface	I/Interface
Intergraph	I/Intergraph
Interholco (part of Danzer)	I/InterholcopartofDanzer
Intermarché	I/Intermarch
Intermet	I/Intermet
International Coal Group	I/InternationalCoalGroup
International Finerhandel	I/InternationalFinerhandel
International Flavors & Fragrances	I/InternationalFlavorsFragrances
International Hardwood Flooring	I/InternationalHardwoodFlooring
International Nickel Company (see Inco)	I/InternationalNickelCompanyseeInco
International Paper	I/InternationalPaper
International Power	I/InternationalPower
International SOS	I/InternationalSOS
International Steel	I/InternationalSteel
Interpublic Group	I/InterpublicGroup
Interquim (part of Akzo Nobel)	I/InterquimpartofAkzoNobel
Interra Systems	I/InterraSystems
Interros	I/Interros
Intersil	I/Intersil
Interstate Hotels	I/InterstateHotels
Intesa Sanpaolo	I/IntesaSanpaolo
Intuit	I/Intuit
INVAP	I/INVAP
Invensys	I/Invensys
Inversiones Castro Jaramillo	I/InversionesCastroJaramillo
Invesco	I/Invesco
Investa Property Group	I/InvestaPropertyGroup
Investec	I/Investec
Invista	I/Invista
Inyatsi	I/Inyatsi
Ion Exchange	I/IonExchange
IOOF	I/IOOF
Iran Khodro	I/IranKhodro
IRPC	I/IRPC
Irving Oil	I/IrvingOil
ISA Group	I/ISAGroup
Iscor	I/Iscor
Ishihara Sangyo Kaisha	I/IshiharaSangyoKaisha
Island Oil & Gas	I/IslandOilGas
Israel Electric	I/IsraelElectric
ISS	I/ISS
Isuzu	I/Isuzu
Italcementi	I/Italcementi
Italthai (Italian-Thai Development Public Company)	I/ItalthaiItalian-ThaiDevelopmentPublicCompany
ITC	I/ITC
Ithaca Fine Chocolates	I/IthacaFineChocolates
ITM Mining	I/ITMMining
Ito-Yokado	I/Ito-Yokado
Itochu	I/Itochu
ITP Group (Industria de Turbo Propulsores)	I/ITPGroupIndustriadeTurboPropulsores
ITT Industries	I/ITTIndustries
ITV	I/ITV
ITW (see Illinois Tool Works)	I/ITWseeIllinoisToolWorks
Ivanhoe Mines	I/IvanhoeMines
J Sainsbury (see Sainsbury)	J/JSainsburyseeSainsbury
JCPenney	J/JCPenney
J.Crew	J/JCrew
J.D. Streett & Co.	J/JDStreettCo
J.P. Sauer & Sohn	J/JPSauerSohn
J.Thomas	J/JThomas
Jabil Circuit	J/JabilCircuit
Jacob's Bakery	J/JacobsBakery
Jacobson Footwear	J/JacobsonFootwear
Jaguar Mining	J/JaguarMining
Jaguar Nickel	J/JaguarNickel
Jamaica Broilers Group	J/JamaicaBroilersGroup
James Finlay (part of Swire)	J/JamesFinlaypartofSwire
James Hardie	J/JamesHardie
Jansport (part of VF Corp.)	J/JansportpartofVFCorp
Japan Airlines	J/JapanAirlines
Japan Tobacco International	J/JapanTobaccoInternational
JAPEX	J/JAPEX
Jaqalanka	J/Jaqalanka
Jardine Matheson	J/JardineMatheson
Java Trading	J/JavaTrading
Jaya Tiasa	J/JayaTiasa
JCI	J/JCI
Jean Coutu Group	J/JeanCoutuGroup
Jefferson Smurfit (now Smurfit Kappa)	J/JeffersonSmurfitnowSmurfitKappa
Jenner & Block	J/JennerBlock
Jeppesen (part of Boeing)	J/JeppesenpartofBoeing
Jet Gold	J/JetGold
JetBlue Airways	J/JetBlueAirways
JFE	J/JFE
JGC	J/JGC
Jianfeng Chemicals	J/JianfengChemicals
Jiangsu Meilan	J/JiangsuMeilan
Jilin Changbai Mountain Fine Chemicals	J/JilinChangbaiMountainFineChemicals
Jilin City JingWei Steel Manufacture	J/JilinCityJingWeiSteelManufacture
Jinan Yuxing General Chemical Plant	J/JinanYuxingGeneralChemicalPlant
Jincheng Anthracite Mining	J/JinchengAnthraciteMining
Jindal	J/Jindal
Jinyuan Group	J/JinyuanGroup
JJB Sports	J/JJBSports
Jo Tankers	J/JoTankers
Jockey	J/Jockey
John Deere	J/JohnDeere
John Fairfax Holdings	J/JohnFairfaxHoldings
John Hancock Financial Services (part of Manulife Financial)	J/JohnHancockFinancialServicespartofManulifeFinancial
John Harvard's Brew House	J/JohnHarvardsBrewHouse
John Keells (part of John Keells Holdings)	J/JohnKeellspartofJohnKeellsHoldings
John Keells Holdings	J/JohnKeellsHoldings
John Lewis (part of John Lewis Partnership)	J/JohnLewispartofJohnLewisPartnership
John Lewis Partnership	J/JohnLewisPartnership
John Ward Ceylon	J/JohnWardCeylon
Johnson & Johnson	J/JohnsonJohnson
Johnson Controls	J/JohnsonControls
Johnson Electric	J/JohnsonElectric
Johnson Matthey	J/JohnsonMatthey
Jonathan's Organics	J/JonathansOrganics
Jones Apparel	J/JonesApparel
Jons Marketplace	J/JonsMarketplace
Jordache	J/Jordache
Jordan Telecom	J/JordanTelecom
Jostens	J/Jostens
Joy Global	J/JoyGlobal
JPMorgan Chase	J/JPMorganChase
Juhua Group	J/JuhuaGroup
Juicy Couture (part of Liz Claiborne)	J/JuicyCouturepartofLizClaiborne
Julius Berger Nigeria (part of Bilfinger Berger)	J/JuliusBergerNigeriapartofBilfingerBerger
Juneyao	J/Juneyao
Just Garments	J/JustGarments
K Line	K/KLine
K+S	K/KS
K-Rep Bank	K/K-RepBank
K2	K/K2
Kader	K/Kader
Kaefer	K/Kaefer
Kahama Mining (part of Barrick Gold)	K/KahamaMiningpartofBarrickGold
Kahn Lucas Lancaster	K/KahnLucasLancaster
Kaiser Aluminum	K/KaiserAluminum
Kaiser Permanente	K/KaiserPermanente
Kajima	K/Kajima
Kalgoorlie Consolidated Gold Mines (joint venture Newmont & Barrick Gold)	K/KalgoorlieConsolidatedGoldMinesjointventureNewmontBarrickGold
Kalyx	K/Kalyx
Kamkorp Microelectronics	K/KamkorpMicroelectronics
Kamlong Industrial	K/KamlongIndustrial
Kansai Electric Power (KEPCO)	K/KansaiElectricPowerKEPCO
Kao	K/Kao
Kappa	K/Kappa
Karachaganak Petroleum Operating (KPO)	K/KarachaganakPetroleumOperatingKPO
KarstadtQuelle	K/KarstadtQuelle
KAS Engineering	K/KASEngineering
Katanga Mining	K/KatangaMining
Katz Group	K/KatzGroup
Kawasaki Heavy Industries	K/KawasakiHeavyIndustries
Kay Jewelers (part of Signet)	K/KayJewelerspartofSignet
Kayu Lapis Indonesia	K/KayuLapisIndonesia
Kazakhmys	K/Kazakhmys
Kazkhrom	K/Kazkhrom
KBC	K/KBC
KBR	K/KBR
Kelda	K/Kelda
Kelian Equatorial Mining (part of Rio Tinto)	K/KelianEquatorialMiningpartofRioTinto
Kellogg	K/Kellogg
Kellogg Brown & Root (see KBR)	K/KelloggBrownRootseeKBR
Kellwood	K/Kellwood
Kelly Services	K/KellyServices
Kelon	K/Kelon
Kemira	K/Kemira
Kenco (part of Kraft Foods)	K/KencopartofKraftFoods
Kenneth Cole	K/KennethCole
Kenya Commercial Bank	K/KenyaCommercialBank
Kenya Tea Development Agency (KTDA)	K/KenyaTeaDevelopmentAgencyKTDA
KEPCO (see Kansai Electric Power)	K/KEPCOseeKansaiElectricPower
KEPCO (see Korea Electric Power)	K/KEPCOseeKoreaElectricPower
Kerr-McGee (now part of Anadarko)	K/Kerr-McGeenowpartofAnadarko
Kesa Electricals	K/KesaElectricals
Kesko	K/Kesko
Ketchum	K/Ketchum
Kettle Foods (part of Lion Capital)	K/KettleFoodspartofLionCapital
KeyBank	K/KeyBank
KeySpan	K/KeySpan
KFC (part of YUM!)	K/KFCpartofYUM
Kimberly-Clark	K/Kimberly-Clark
Kimpton Hotels & Restaurants	K/KimptonHotelsRestaurants
Kinder Morgan Energy Partners (part of Kinder Morgan Inc.)	K/KinderMorganEnergyPartnerspartofKinderMorganInc
Kinder Morgan Inc.	K/KinderMorganInc
Kingfisher	K/Kingfisher
Kingkey Group	K/KingkeyGroup
Kingmaker Footwear	K/KingmakerFootwear
Kingold Group	K/KingoldGroup
Kinko's (see FedEx Kinko's [part of FedEx])	K/KinkosseeFedExKinkospartofFedEx
Kinoshita	K/Kinoshita
Kinross Gold	K/KinrossGold
Kinross-Forrest (part of Katanga Mining)	K/Kinross-ForrestpartofKatangaMining
Kinyara Sugar Works	K/KinyaraSugarWorks
KLM (part of Air France KLM)	K/KLMpartofAirFranceKLM
KLP Forsikring	K/KLPForsikring
Kmart (part of Sears)	K/KmartpartofSears
KMC Oiltools	K/KMCOiltools
Knight Ridder	K/KnightRidder
Knoll	K/Knoll
Ko Kong Sugar	K/KoKongSugar
Ko Ngar Gems	K/KoNgarGems
Koch Industries	K/KochIndustries
Kodak (see Eastman Kodak)	K/KodakseeEastmanKodak
KOGAS (Korea Gas Corporation)	K/KOGASKoreaGasCorporation
Kohl's	K/Kohls
Kohler	K/Kohler
Komex (part of WorleyParsons)	K/KomexpartofWorleyParsons
KOMIPO (see Korea Midland Power)	K/KOMIPOseeKoreaMidlandPower
Konica	K/Konica
Konka	K/Konka
Konkan Railway	K/KonkanRailway
"Konkola Copper Mines (joint venture Vedanta Resources, Zambia Copper Investments & ZCCM Investments)"	K/KonkolaCopperMinesjointventureVedantaResourcesZambiaCopperInvestmentsZCCMInvestments
Kookmin Bank	K/KookminBank
Korea East-West Power (part of Korea Electric Power)	K/KoreaEast-WestPowerpartofKoreaElectricPower
Korea Electric Power (KEPCO)	K/KoreaElectricPowerKEPCO
Korea Gas Corporation (see KOGAS)	K/KoreaGasCorporationseeKOGAS
Korea Land	K/KoreaLand
Korea Midland Power (part of Korea Electric Power)	K/KoreaMidlandPowerpartofKoreaElectricPower
Korea National Oil	K/KoreaNationalOil
Korea Telecom (KT)	K/KoreaTelecomKT
Korea Tobacco	K/KoreaTobacco
Korea United Pharm	K/KoreaUnitedPharm
Korea Water Resources (KOWACO)	K/KoreaWaterResourcesKOWACO
Korean Air (part of Hanjin Group)	K/KoreanAirpartofHanjinGroup
Koret (part of Kellwood)	K/KoretpartofKellwood
Kosiuko	K/Kosiuko
Kosmos Energy	K/KosmosEnergy
KOWACO (see Korea Water Resources)	K/KOWACOseeKoreaWaterResources
Koza Davetiye	K/KozaDavetiye
KPMG	K/KPMG
Kraft Foods	K/KraftFoods
Kras	K/Kras
Krenholm (part of Boras Wäfveri)	K/KrenholmpartofBorasWfveri
Kroger	K/Kroger
Kroll	K/Kroll
Krones	K/Krones
Kronospan	K/Kronospan
Kubota	K/Kubota
Kumba Resources (now Exxaro)	K/KumbaResourcesnowExxaro
Kumho Asiana	K/KumhoAsiana
Kunming Light Industry Machinery	K/KunmingLightIndustryMachinery
Kuoni	K/Kuoni
Kuraray	K/Kuraray
Kvaerner (see Aker Kvaerner)	K/KvaernerseeAkerKvaerner
Kwilu- Ngongo	K/Kwilu-Ngongo
Kyobo	K/Kyobo
Kyocera	K/Kyocera
L'Oreal	L/LOreal
L-3 Communications	L/L-3Communications
L-3 Titan (part of L-3 Communications)	L/L-3TitanpartofL-3Communications
L.L.Bean	L/LLBean
La Fragua (part of Central American Retail)	L/LaFraguapartofCentralAmericanRetail
La Nación	L/LaNacin
La Razón (part of Grupo Planeta)	L/LaRaznpartofGrupoPlaneta
La Senza	L/LaSenza
La Siembra	L/LaSiembra
Laboratoires Vendôme	L/LaboratoiresVendme
LaBranche	L/LaBranche
Lacoste (part of Devanlay)	L/LacostepartofDevanlay
Lafarge	L/Lafarge
Lagardère	L/Lagardre
Laguna Azul	L/LagunaAzul
Lahmeyer	L/Lahmeyer
Laigang	L/Laigang
Laiwu Iron and Steel (see Laigang)	L/LaiwuIronandSteelseeLaigang
Lajat (see Grupo Lajat)	L/LajatseeGrupoLajat
Lambert Howarth	L/LambertHowarth
Lan Airlines	L/LanAirlines
Lance	L/Lance
Land Bank of the Philippines	L/LandBankofthePhilippines
Land Rover (part of Ford)	L/LandRoverpartofFord
Land Securities	L/LandSecurities
Land Systems OMC (part of BAE Systems)	L/LandSystemsOMCpartofBAESystems
Land's End (part of Sears)	L/LandsEndpartofSears
Lane Bryant (part of Charming Shoppes)	L/LaneBryantpartofCharmingShoppes
Lapa Rios Ecolodge	L/LapaRiosEcolodge
Larsen & Toubro	L/LarsenToubro
LaSalle Bank (part of ABN Amro)	L/LaSalleBankpartofABNAmro
Lasco Group	L/LascoGroup
Lasmo Runtu	L/LasmoRuntu
Laura Ashley	L/LauraAshley
Laurent-Perrier	L/Laurent-Perrier
Laurus	L/Laurus
Lavera	L/Lavera
Lazare Kaplan	L/LazareKaplan
Le Coq Sportif (see Coq Sportif)	L/LeCoqSportifseeCoqSportif
Leader Garments (part of Makalot)	L/LeaderGarmentspartofMakalot
LeapFrog	L/LeapFrog
Lear	L/Lear
Leber Jeweler	L/LeberJeweler
Leclerc	L/Leclerc
Ledesma	L/Ledesma
Leeward Capital	L/LeewardCapital
Legal & General	L/LegalGeneral
Leggett & Platt	L/LeggettPlatt
Lego	L/Lego
Lehman Brothers	L/LehmanBrothers
Leica Geosystems	L/LeicaGeosystems
Leigh Day	L/LeighDay
Leighton	L/Leighton
Lennar	L/Lennar
Lenovo	L/Lenovo
Lenscrafters	L/Lenscrafters
Leo Burnett (part of Publicis)	L/LeoBurnettpartofPublicis
Lepanto Consolidated Mining	L/LepantoConsolidatedMining
Leroy Merlin	L/LeroyMerlin
Leslie Davis (part of Signet)	L/LeslieDavispartofSignet
Leslie Fay	L/LeslieFay
Leumi	L/Leumi
Lev Leviev Group	L/LevLevievGroup
Levi Strauss	L/LeviStrauss
Lexmark	L/Lexmark
LG Electronics (LGE) (part of LG Group chaebol)	L/LGElectronicsLGEpartofLGGroupchaebol
Li & Fung	L/LiFung
Li Ning	L/LiNing
Lian Industrial	L/LianIndustrial
Liberty Life	L/LibertyLife
Liberty Media	L/LibertyMedia
Liberty Mutual	L/LibertyMutual
Liberty National Life Insurance (part of Torchmark)	L/LibertyNationalLifeInsurancepartofTorchmark
Liberty PLC	L/LibertyPLC
Lider (part of D&S)	L/LiderpartofDS
Lidl	L/Lidl
Life of Jamaica	L/LifeofJamaica
LifeScan	L/LifeScan
Liggett (part of Vector Group)	L/LiggettpartofVectorGroup
LightPointe	L/LightPointe
Lilly (see Eli Lilly)	L/LillyseeEliLilly
Limited Brands	L/LimitedBrands
Lincoln National	L/LincolnNational
Lion Capital	L/LionCapital
Lion Energy	L/LionEnergy
Littlewoods	L/Littlewoods
Liverpool Football Club	L/LiverpoolFootballClub
Liz Claiborne	L/LizClaiborne
LKQ Corporation	L/LKQCorporation
Lloyd's of London	L/LloydsofLondon
Lloyds TSB	L/LloydsTSB
Loblaw Companies	L/LoblawCompanies
Lockheed Martin	L/LockheedMartin
Lockton	L/Lockton
Lone Star Steakhouse	L/LoneStarSteakhouse
Lonely Planet	L/LonelyPlanet
Long & Foster	L/LongFoster
Lonmin	L/Lonmin
Lonmin Platinum (part of Lonmin)	L/LonminPlatinumpartofLonmin
Lorillard Tobacco (part of Carolina Group)	L/LorillardTobaccopartofCarolinaGroup
Lotte Shopping	L/LotteShopping
Lotteria	L/Lotteria
Lotto	L/Lotto
Louis Berger	L/LouisBerger
Louis Dreyfus	L/LouisDreyfus
Louisiana-Pacific	L/Louisiana-Pacific
Louisville Gas & Electric (part of E.ON)	L/LouisvilleGasElectricpartofEON
Lowe's	L/Lowes
LP (see Louisiana-Pacific)	L/LPseeLouisiana-Pacific
LSG Sky Chefs	L/LSGSkyChefs
Lucent Technologies (now Alcatel-Lucent)	L/LucentTechnologiesnowAlcatel-Lucent
Lucite	L/Lucite
Lucky Gems & Jewellery (part of Lucky International)	L/LuckyGemsJewellerypartofLuckyInternational
Lucky International	L/LuckyInternational
Luen Thai	L/LuenThai
Lufkin Industries	L/LufkinIndustries
Lufthansa	L/Lufthansa
Lukarco (joint venture Lukoil & Arco)	L/LukarcojointventureLukoilArco
Lukoil	L/Lukoil
Lumanhe	L/Lumanhe
Lumbermens	L/Lumbermens
"Luminas (Sociedade Mineira de Luminas) (joint venture Lev Leviev, Endiama & Twins Ltd)"	L/LuminasSociedadeMineiradeLuminasjointventureLevLevievEndiamaTwinsLtd
Luna Park	L/LunaPark
Lundbeck	L/Lundbeck
Lundin Petroleum	L/LundinPetroleum
Lung Cheong International	L/LungCheongInternational
Lupin	L/Lupin
Luscar	L/Luscar
Lux Bond & Green	L/LuxBondGreen
Luzon Minerals	L/LuzonMinerals
LVMH	L/LVMH
Lyondell	L/Lyondell
Mabuhay Vinyl	M/MabuhayVinyl
MAC Cosmetics (part of Estée Lauder)	M/MACCosmeticspartofEsteLauder
MACIF	M/MACIF
Macquarie Bank	M/MacquarieBank
Macrolink Group	M/MacrolinkGroup
Macy's (part of Federated Department Stores)	M/MacyspartofFederatedDepartmentStores
Madhvani International	M/MadhvaniInternational
Madison Square Garden (part of Cablevision)	M/MadisonSquareGardenpartofCablevision
Maersk (part of A.P. Moller - Maersk)	M/MaerskpartofAPMoller-Maersk
Mafatlal Industries (part of Arvind Mafatlal Group)	M/MafatlalIndustriespartofArvindMafatlalGroup
Magadi Soda (part of Brunner Mond)	M/MagadiSodapartofBrunnerMond
Magna	M/Magna
Magnesium Elektron	M/MagnesiumElektron
Mahindra & Mahindra	M/MahindraMahindra
Mahyco	M/Mahyco
Main Glove	M/MainGlove
Mainland Headwear	M/MainlandHeadwear
Mainstream (part of Cermaq)	M/MainstreampartofCermaq
Maithan Group	M/MaithanGroup
Maithan Ispat (part of Maithan Group)	M/MaithanIspatpartofMaithanGroup
Majescor	M/Majescor
Majestic Athletic	M/MajesticAthletic
Majuko	M/Majuko
Makalot	M/Makalot
Makhteshim Chemical Works	M/MakhteshimChemicalWorks
Malaysia Airlines	M/MalaysiaAirlines
Malcom	M/Malcom
Mallinckrodt (part of Tyco)	M/MallinckrodtpartofTyco
Maloney Group	M/MaloneyGroup
MAN	M/MAN
Man Group	M/ManGroup
Manaaki Whenua	M/ManaakiWhenua
Mango	M/Mango
Manhattan Minerals	M/ManhattanMinerals
"Manila Water (joint venture Ayala, Mitsubishi & United Utilities)"	M/ManilaWaterjointventureAyalaMitsubishiUnitedUtilities
Manildra	M/Manildra
Manildra Park Petroleum (part of Manildra)	M/ManildraParkPetroleumpartofManildra
Manpower	M/Manpower
Manulife Financial	M/ManulifeFinancial
Manurhin (part of Chapuis Armes - Manurhin)	M/ManurhinpartofChapuisArmes-Manurhin
MAPFRE	M/MAPFRE
Maple-Brown Abbott	M/Maple-BrownAbbott
Marathon Ashland (joint venture Ashland & Marathon Oil)	M/MarathonAshlandjointventureAshlandMarathonOil
Marathon Oil	M/MarathonOil
Marco Aldany	M/MarcoAldany
Marie Claire (UK) (part of Time Warner)	M/MarieClaireUKpartofTimeWarner
Marimekko	M/Marimekko
Marine Harvest	M/MarineHarvest
Marks & Spencer	M/MarksSpencer
Maroc Telecom	M/MarocTelecom
Marriott	M/Marriott
Mars	M/Mars
"Marschollek, Lautenschläger und Partner"	M/MarschollekLautenschlgerundPartner
Marsh & McLennan	M/MarshMcLennan
Marsh (part of Marsh & McLennan)	M/MarshpartofMarshMcLennan
Marshall Fields (part of May Department Stores)	M/MarshallFieldspartofMayDepartmentStores
Marshalls plc	M/Marshallsplc
Martha Tilaar	M/MarthaTilaar
Martinson Konfektion	M/MartinsonKonfektion
Marubeni	M/Marubeni
Maruti Suzuki (part of Suzuki)	M/MarutiSuzukipartofSuzuki
Mary Kay	M/MaryKay
Marzotto	M/Marzotto
MAS Holdings	M/MASHoldings
Mason-Kay	M/Mason-Kay
Mass Transit Railway	M/MassTransitRailway
Massey Energy	M/MasseyEnergy
MassMutual	M/MassMutual
Mast Industries	M/MastIndustries
Matalan	M/Matalan
Matrix Laboratories	M/MatrixLaboratories
Matsushita	M/Matsushita
Mattel	M/Mattel
Maurel & Prom	M/MaurelProm
Mauser-Werke	M/Mauser-Werke
Maverick Mining	M/MaverickMining
Max Havelaar	M/MaxHavelaar
Max India	M/MaxIndia
Maxims	M/Maxims
May Department Stores	M/MayDepartmentStores
Maybelline (part of L'Oreal)	M/MaybellinepartofLOreal
Maytag	M/Maytag
Mazda	M/Mazda
MBDA	M/MBDA
MBI	M/MBI
MBNA (part of Bank of America)	M/MBNApartofBankofAmerica
McCann-Erickson Worldwide (part of Interpublic Group)	M/McCann-EricksonWorldwidepartofInterpublicGroup
McCarthy	M/McCarthy
McDermott	M/McDermott
McDermott Will & Emery	M/McDermottWillEmery
McDonald's	M/McDonalds
McGregor Fashion	M/McGregorFashion
MCI	M/MCI
McKesson	M/McKesson
McKinsey	M/McKinsey
McWane	M/McWane
MDM Bank (part of MDM Financial)	M/MDMBankpartofMDMFinancial
MDM Financial	M/MDMFinancial
ME Sportwaffen	M/MESportwaffen
Mead Johnson (part of Bristol-Myers Squibb)	M/MeadJohnsonpartofBristol-MyersSquibb
MeadWestvaco	M/MeadWestvaco
Meals	M/Meals
Medan Tropical Canning	M/MedanTropicalCanning
MedcoEnergi	M/MedcoEnergi
Media 24 (part of Naspers)	M/Media24partofNaspers
Media General	M/MediaGeneral
MediaNews Group	M/MediaNewsGroup
Mediobanca	M/Mediobanca
Medtronic	M/Medtronic
Mehta Group	M/MehtaGroup
Meijer	M/Meijer
Meiji Dairies	M/MeijiDairies
Mellon Financial	M/MellonFinancial
Melvita	M/Melvita
Menard	M/Menard
Menarini	M/Menarini
Mengniu Group	M/MengniuGroup
Menhaj Technologies	M/MenhajTechnologies
Menlo Worldwide Forwarding	M/MenloWorldwideForwarding
Mercedes-Benz (part of DaimlerChrysler)	M/Mercedes-BenzpartofDaimlerChrysler
Merck	M/Merck
Merck Sharp & Dohme (part of Merck)	M/MerckSharpDohmepartofMerck
Mercuri Urval	M/MercuriUrval
Meridian Gold	M/MeridianGold
Merisant	M/Merisant
Merloni Elettrodomestici	M/MerloniElettrodomestici
Merrill Lynch	M/MerrillLynch
Merton Company	M/MertonCompany
Mervyn's	M/Mervyns
Metalclad (part of Entrx)	M/MetalcladpartofEntrx
Metaleurop	M/Metaleurop
Metallica Resources	M/MetallicaResources
Metalor	M/Metalor
Meteoric Tactical Solutions	M/MeteoricTacticalSolutions
Methanex	M/Methanex
Metlife	M/Metlife
Metorex	M/Metorex
Metro	M/Metro
Metrogas	M/Metrogas
Mexicana de Lubricantes	M/MexicanadeLubricantes
MEXX (part of Liz Claiborne)	M/MEXXpartofLizClaiborne
MGA Entertainment	M/MGAEntertainment
MGM Mirage	M/MGMMirage
Miaoshi Dairy	M/MiaoshiDairy
MIBA	M/MIBA
MIBRAG - Mitteldeutsche Braunkohlenwerke (joint venture Washington Group & NRG Energy)	M/MIBRAG-MitteldeutscheBraunkohlenwerkejointventureWashingtonGroupNRGEnergy
Michelin	M/Michelin
Micron	M/Micron
Microsoft	M/Microsoft
MidAmerican Energy (part of Berkshire Hathaway)	M/MidAmericanEnergypartofBerkshireHathaway
Midas	M/Midas
Midas Safety	M/MidasSafety
Mideast Integrated Steel (MESCO)	M/MideastIntegratedSteelMESCO
Midland Company	M/MidlandCompany
MiG	M/MiG
Migros	M/Migros
Mikasa	M/Mikasa
Military Professional Resources Inc (see MPRI)	M/MilitaryProfessionalResourcesIncseeMPRI
Millea	M/Millea
Millennium Chemicals (part of Lyondell)	M/MillenniumChemicalspartofLyondell
Miller Brewing (part of SABMiller)	M/MillerBrewingpartofSABMiller
Milliken	M/Milliken
Millivres Prowler Group	M/MillivresProwlerGroup
Millstone	M/Millstone
Milpo	M/Milpo
Minera Alumbrera (part of Musto Exploration [joint venture Goldcorp & Northern Orion Resources] & Xstrata)	M/MineraAlumbrerapartofMustoExplorationjointventureGoldcorpNorthernOrionResourcesXstrata
Minera Majaz (part of Monterrico Metals)	M/MineraMajazpartofMonterricoMetals
Minera San Xavier (part of Metallica Resources)	M/MineraSanXavierpartofMetallicaResources
Minera Sud Argentina	M/MineraSudArgentina
Minera Tizapa (joint venture Peñoles & Dowa)	M/MineraTizapajointventurePeolesDowa
Minera Yanacocha (joint venture Newmont & Compañía de Minas Buenaventura)	M/MineraYanacochajointventureNewmontCompaadeMinasBuenaventura
Minera Zaldívar (part of Placer Dome)	M/MineraZaldvarpartofPlacerDome
Mininco	M/Mininco
Minnkota Power Cooperative	M/MinnkotaPowerCooperative
Minosa (part of Banco Atlántida)	M/MinosapartofBancoAtlntida
Mirage (part of MGM Mirage)	M/MiragepartofMGMMirage
Mirant	M/Mirant
Mirenco	M/Mirenco
Mishuai Apparel (see Shaoxing Mishuai Dress Making)	M/MishuaiApparelseeShaoxingMishuaiDressMaking
Mission Linen	M/MissionLinen
Mister Pizza [So. Korea]	M/MisterPizzaSoKorea
Mitane Textile	M/MitaneTextile
Mitchell Gold + Bob Williams	M/MitchellGoldBobWilliams
Mitchells & Butlers	M/MitchellsButlers
Mito	M/Mito
Mitre Sports	M/MitreSports
Mitsubishi	M/Mitsubishi
Mitsubishi Heavy Industries	M/MitsubishiHeavyIndustries
Mitsubishi Materials (part of Mitsubishi)	M/MitsubishiMaterialspartofMitsubishi
Mitsui	M/Mitsui
Mitsui Mining	M/MitsuiMining
Mitsui O.S.K. Lines (MOL)	M/MitsuiOSKLinesMOL
Mitsui Sumitomo Insurance (part of Sumitomo Group)	M/MitsuiSumitomoInsurancepartofSumitomoGroup
Mittal Steel (part of Arcelor Mittal)	M/MittalSteelpartofArcelorMittal
Mizuho Bank (part of Mizuho Financial Group)	M/MizuhoBankpartofMizuhoFinancialGroup
Mizuno	M/Mizuno
MK One (part of Baugur)	M/MKOnepartofBaugur
MKEK	M/MKEK
MKJ Explorations	M/MKJExplorations
MLC (part of National Australia Bank)	M/MLCpartofNationalAustraliaBank
MMC	M/MMC
mmo2 (now O2)	M/mmo2nowO2
Moattama Gas Transportation Company (part of Total)	M/MoattamaGasTransportationCompanypartofTotal
Mobil Oil (part of ExxonMobil)	M/MobilOilpartofExxonMobil
Mobile Telecommunications Company	M/MobileTelecommunicationsCompany
Modandola Group	M/ModandolaGroup
Modi Enterprises	M/ModiEnterprises
Modicare (part of Modi Enterprises)	M/ModicarepartofModiEnterprises
Moët Hennessy Louis Vuitton (see LVMH)	M/MotHennessyLouisVuittonseeLVMH
Mohawk Industries	M/MohawkIndustries
MOL (see Mitsui O.S.K. Lines or Magyar Olaj Gazi)	M/MOLseeMitsuiOSKLinesorMagyarOlajGazi
Molson (part of Molson Coors)	M/MolsonpartofMolsonCoors
Molson Coors	M/MolsonCoors
Moltex Sporting Goods	M/MoltexSportingGoods
Moncrief Oil	M/MoncriefOil
Mondi (part of Anglo American)	M/MondipartofAngloAmerican
Monoprix	M/Monoprix
Monsanto	M/Monsanto
Monsoon	M/Monsoon
Montagne	M/Montagne
Monterrico Metals	M/MonterricoMetals
Montres Rolex (see Rolex)	M/MontresRolexseeRolex
Moody's	M/Moodys
Moonie (part of Santos)	M/MooniepartofSantos
Morgan Stanley	M/MorganStanley
"Morgan, Lewis & Bockius"	M/MorganLewisBockius
Morley Fund Management (part of Aviva)	M/MorleyFundManagementpartofAviva
Morrison & Foerster	M/MorrisonFoerster
Morrisons	M/Morrisons
Mothercare	M/Mothercare
Mothers Work	M/MothersWork
Motiva Enterprises (joint venture Shell & Saudi Aramco)	M/MotivaEnterprisesjointventureShellSaudiAramco
Motorola	M/Motorola
Movistar (part of Telefónica)	M/MovistarpartofTelefnica
MphasiS	M/MphasiS
MPRI (part of L-3 Communications)	M/MPRIpartofL-3Communications
Mr Price	M/MrPrice
Msauli	M/Msauli
Mt. Olive Pickle	M/MtOlivePickle
MTN	M/MTN
MTR	M/MTR
MTV (part of Viacom)	M/MTVpartofViacom
MTV Networks Europe (part of Viacom)	M/MTVNetworksEuropepartofViacom
Multienlace	M/Multienlace
Munich Re	M/MunichRe
Murphy Oil	M/MurphyOil
Murray and Roberts	M/MurrayandRoberts
Murugappa	M/Murugappa
Musim Mas	M/MusimMas
MV Transportation	M/MVTransportation
Mvelaphanda Group	M/MvelaphandaGroup
Myanma Gem Enterprise	M/MyanmaGemEnterprise
Myanmar Oil & Gas Enterprise (MOGE)	M/MyanmarOilGasEnterpriseMOGE
Myanmar Timber Enterprise	M/MyanmarTimberEnterprise
Mylan Laboratories	M/MylanLaboratories
Mysore Minerals	M/MysoreMinerals
Mysore Paper Mills	M/MysorePaperMills
MySpace.com (part of News Corporation)	M/MySpacecompartofNewsCorporation
Mytilineos	M/Mytilineos
MyTravel	M/MyTravel
Naf Naf	N/NafNaf
Nakumatt Holdings	N/NakumattHoldings
NALCO	N/NALCO
"Nam Fatt (joint venture Petronas, Land & General, Mitsui)"	N/NamFattjointventurePetronasLandGeneralMitsui
Nam Theun 2 Power (intl. consortium)	N/NamTheun2Powerintlconsortium
"Namdeb (joint venture De Beers, Namibia Govt.)"	N/NamdebjointventureDeBeersNamibiaGovt
NamPower	N/NamPower
Nanjing Iron and Steel Union	N/NanjingIronandSteelUnion
Nanjing Ruikang Agriculture	N/NanjingRuikangAgriculture
Napapijri	N/Napapijri
Napier Industries	N/NapierIndustries
Narmada Hydroelectric Development Corporation (NHDC) (joint venture NHPC [National Hydroelectric Power Corporation] & Madhya Pradesh Govt.)	N/NarmadaHydroelectricDevelopmentCorporationNHDCjointventureNHPCNationalHydroelectricPowerCorporationMadhyaPradeshGovt
Naspers Group	N/NaspersGroup
Natexis (part of Groupe Banque Populaire)	N/NatexispartofGroupeBanquePopulaire
National Australia Bank	N/NationalAustraliaBank
National Bank of Canada	N/NationalBankofCanada
National Commercial Bank	N/NationalCommercialBank
National Commercial Bank Jamaica	N/NationalCommercialBankJamaica
National Express	N/NationalExpress
National Grid	N/NationalGrid
National Gypsum	N/NationalGypsum
National Hydroelectric Power Corporation (see NHPC)	N/NationalHydroelectricPowerCorporationseeNHPC
National Material	N/NationalMaterial
National Mineral Development Corporation (NMDC)	N/NationalMineralDevelopmentCorporationNMDC
National Semiconductor	N/NationalSemiconductor
National Steel	N/NationalSteel
National Transmission Corporation (Transco) [Philippines]	N/NationalTransmissionCorporationTranscoPhilippines
National Wire Fabric (part of Gamma Holding)	N/NationalWireFabricpartofGammaHolding
Nationwide	N/Nationwide
Natixis (joint venture Caisse d'Epargne & Groupe Banque Populaire)	N/NatixisjointventureCaissedEpargneGroupeBanquePopulaire
Natura	N/Natura
NatWest (part of Royal Bank of Scotland)	N/NatWestpartofRoyalBankofScotland
Nautica (part of VF Corp)	N/NauticapartofVFCorp
NBC (joint venture General Electric & Vivendi Universal)	N/NBCjointventureGeneralElectricVivendiUniversal
NBCC	N/NBCC
NCC	N/NCC
NCR	N/NCR
Nebraska Beef	N/NebraskaBeef
NEC	N/NEC
Nedbank	N/Nedbank
Nedcor (see Nedbank)	N/NedcorseeNedbank
Nederburg	N/Nederburg
Neelachal Ispat Nigam	N/NeelachalIspatNigam
Neilson Travel (part of Thomas Cook)	N/NeilsonTravelpartofThomasCook
Neiman Marcus	N/NeimanMarcus
Nera	N/Nera
NestlÃ©	N/Nestl
NetEase	N/NetEase
Network Equipment Technologies	N/NetworkEquipmentTechnologies
Network Rail	N/NetworkRail
Nevsun	N/Nevsun
New Balance	N/NewBalance
New Era Cap	N/NewEraCap
New Gomair	N/NewGomair
New Lachaussée	N/NewLachausse
New Look	N/NewLook
New Millennium Resources	N/NewMillenniumResources
New NGC (see National Gypsum)	N/NewNGCseeNationalGypsum
New Society	N/NewSociety
New United Motor Manufacturing (joint venture General Motors & Toyota)	N/NewUnitedMotorManufacturingjointventureGeneralMotorsToyota
New Wave Group	N/NewWaveGroup
New World Development	N/NewWorldDevelopment
New York Life	N/NewYorkLife
New York Times	N/NewYorkTimes
New-Ray	N/New-Ray
Newco	N/Newco
Newcrest	N/Newcrest
Newell Rubbermaid	N/NewellRubbermaid
Newman's Own	N/NewmansOwn
Newman's Own Organics	N/NewmansOwnOrganics
Newmann Kaffee	N/NewmannKaffee
NewMarket	N/NewMarket
Newmont	N/Newmont
News Corporation	N/NewsCorporation
Nexen	N/Nexen
Nexsys	N/Nexsys
Next	N/Next
Next Media	N/NextMedia
Nexter	N/Nexter
Nexum	N/Nexum
NFC Africa (part of China Non-ferrous Metal Industrys Foreign Engineering & Construction (NFC))	N/NFCAfricapartofChinaNon-ferrousMetalIndustrysForeignEngineeringConstructionNFC
NH	N/NH
NHPC (National Hydroelectric Power Corporation - India)	N/NHPCNationalHydroelectricPowerCorporation-India
Niagara Mohawk Power	N/NiagaraMohawkPower
NIC Bank	N/NICBank
Nickelodeon (part of Viacom)	N/NickelodeonpartofViacom
Nico-Pyrotechnik	N/Nico-Pyrotechnik
Nien Hsing	N/NienHsing
Nigeria Liquefied Natural Gas (NLNG)	N/NigeriaLiquefiedNaturalGasNLNG
"Nigerian Agip Oil Company (NAOC) (joint venture Nigerian National Petroleum Corporation, ENI, ConocoPhillips)"	N/NigerianAgipOilCompanyNAOCjointventureNigerianNationalPetroleumCorporationENIConocoPhillips
Nigerian Breweries	N/NigerianBreweries
Nigerian National Petroleum Company (NNPC)	N/NigerianNationalPetroleumCompanyNNPC
Nikanor	N/Nikanor
Nike	N/Nike
Nikki Shoji (part of JGC)	N/NikkiShojipartofJGC
Nikko Cordial	N/NikkoCordial
Nikko Hotels (part of Japan Airlines)	N/NikkoHotelspartofJapanAirlines
Nile Clothing	N/NileClothing
Nine Dragons Paper	N/NineDragonsPaper
Nine West (part of Jones Apparel)	N/NineWestpartofJonesApparel
Ningbo Wuzhouxing	N/NingboWuzhouxing
Nintendo	N/Nintendo
Nippon Koei	N/NipponKoei
Nippon Life Insurance	N/NipponLifeInsurance
Nippon Mining	N/NipponMining
Nippon Mining & Metals (part of Nippon Mining)	N/NipponMiningMetalspartofNipponMining
Nippon Oil	N/NipponOil
Nippon Sharyo	N/NipponSharyo
Nippon Steel	N/NipponSteel
Nishimatsu Construction	N/NishimatsuConstruction
Nissan	N/Nissan
Nissei	N/Nissei
Nissho Iwai (see Sojitz)	N/NisshoIwaiseeSojitz
Nixon Peabody	N/NixonPeabody
NKG Tropical Farm Management (see Tropical Farm Management)	N/NKGTropicalFarmManagementseeTropicalFarmManagement
NL Industries	N/NLIndustries
No Sweat Apparel	N/NoSweatApparel
Nobland	N/Nobland
Noble Caledonia	N/NobleCaledonia
Nobleza Piccardo (part of British American Tobacco)	N/NoblezaPiccardopartofBritishAmericanTobacco
Noboa	N/Noboa
Noel Leeming	N/NoelLeeming
NOK	N/NOK
Nokia	N/Nokia
Nomura	N/Nomura
Noranda (part of Falconbridge)	N/NorandapartofFalconbridge
Nord Race	N/NordRace
Nordea Bank	N/NordeaBank
Nordstrom	N/Nordstrom
Norfolk Southern	N/NorfolkSouthern
Norilsk Nickel	N/NorilskNickel
NORINCO (China North Industries)	N/NORINCOChinaNorthIndustries
Noroxo (part of ExxonMobil)	N/NoroxopartofExxonMobil
Norsk Hydro	N/NorskHydro
Norske Skog	N/NorskeSkog
NorskeCanada (part of Norske Skog)	N/NorskeCanadapartofNorskeSkog
Nortel Networks	N/NortelNetworks
North Face (part of VF Corp)	N/NorthFacepartofVFCorp
North Sails (see Global Sports Lanka)	N/NorthSailsseeGlobalSportsLanka
Northbridge Services Group	N/NorthbridgeServicesGroup
Northeast Utilities	N/NortheastUtilities
Northern Foods	N/NorthernFoods
Northern Orion Resources	N/NorthernOrionResources
Northern Rock	N/NorthernRock
Northern States Power (part of Xcel Energy)	N/NorthernStatesPowerpartofXcelEnergy
Northgate Minerals	N/NorthgateMinerals
Northrop Grumman	N/NorthropGrumman
Northwest Airlines	N/NorthwestAirlines
Northwest Natural Gas	N/NorthwestNaturalGas
Norton Rose	N/NortonRose
Norwegian Cruise Line (part of Star Cruises)	N/NorwegianCruiseLinepartofStarCruises
Norwich & Peterborough	N/NorwichPeterborough
Norwich Union (part of Aviva)	N/NorwichUnionpartofAviva
Nottingham Forest	N/NottinghamForest
Nova Banka Bijeljina	N/NovaBankaBijeljina
Nova Gas	N/NovaGas
Novartis	N/Novartis
Novatek	N/Novatek
Novem Car Interior Design	N/NovemCarInteriorDesign
Novo Group	N/NovoGroup
Novo Nordisk (part of Novo Group)	N/NovoNordiskpartofNovoGroup
Novozymes	N/Novozymes
NOW Magazine (UK) (part of Time Warner)	N/NOWMagazineUKpartofTimeWarner
NPI Wireless	N/NPIWireless
npower (part of RWE)	N/npowerpartofRWE
NRG Energy	N/NRGEnergy
NRL (see Numaligarh Refinery)	N/NRLseeNumaligarhRefinery
NSTAR	N/NSTAR
NTPC	N/NTPC
Nucete	N/Nucete
Nuclear Metals (see Starmet)	N/NuclearMetalsseeStarmet
Nucleus Software	N/NucleusSoftware
Nucor	N/Nucor
Numaligarh Refinery (NRL)	N/NumaligarhRefineryNRL
Numico (see Royal Numico)	N/NumicoseeRoyalNumico
NuStart Energy	N/NuStartEnergy
Nutraceutical Intl.	N/NutraceuticalIntl
Nutreco	N/Nutreco
Nuziveedu Seeds	N/NuziveeduSeeds
NVE Pharmaceuticals	N/NVEPharmaceuticals
NW Natural (see Northwest Natural Gas)	N/NWNaturalseeNorthwestNaturalGas
Nycomed	N/Nycomed
NYK Line	N/NYKLine
O Boticário	O/OBoticrio
O'Neill	O/ONeill
O2 (part of Telefónica)	O/O2partofTelefnica
Observer (UK) (part of Guardian Media)	O/ObserverUKpartofGuardianMedia
OCBC Bank	O/OCBCBank
Occidental Chemical (part of Occidental Petroleum)	O/OccidentalChemicalpartofOccidentalPetroleum
Occidental Petroleum	O/OccidentalPetroleum
OCS	O/OCS
Octel	O/Octel
Odebrecht	O/Odebrecht
Odfjell	O/Odfjell
Office Depot	O/OfficeDepot
OfficeMax	O/OfficeMax
OHL Group (see Grupo OHL)	O/OHLGroupseeGrupoOHL
OIEC	O/OIEC
Oil & Natural Gas Corporation (see ONGC)	O/OilNaturalGasCorporationseeONGC
Oil India	O/OilIndia
Oil Search	O/OilSearch
Ok Tedi Mining	O/OkTediMining
Okaidi	O/Okaidi
Okaya	O/Okaya
Oki	O/Oki
Oklanicsa	O/Oklanicsa
Olam	O/Olam
Olay (part of Procter & Gamble)	O/OlaypartofProcterGamble
Old Mutual	O/OldMutual
Old Navy (part of Gap)	O/OldNavypartofGap
Oldcastle Materials (part of CRH)	O/OldcastleMaterialspartofCRH
Olivia Companies	O/OliviaCompanies
OM Group	O/OMGroup
Omni Hotels	O/OmniHotels
Omnicom	O/Omnicom
Omron	O/Omron
OMV	O/OMV
OneNest	O/OneNest
ONGC (Oil & Natural Gas Corporation)	O/ONGCOilNaturalGasCorporation
Ontario Power Generation (OPG)	O/OntarioPowerGenerationOPG
Onyx (part of Veolia Environnement)	O/OnyxpartofVeoliaEnvironnement
OOCL (part of Orient Overseas (International) Limited)	O/OOCLpartofOrientOverseasInternationalLimited
Open Text	O/OpenText
OPG (see Ontario Power Generation)	O/OPGseeOntarioPowerGeneration
Oppenheimer & Co.	O/OppenheimerCo
Opps (Ouro Preto Pedra Sabão)	O/OppsOuroPretoPedraSabo
Oracle	O/Oracle
Orange	O/Orange
Orascom	O/Orascom
Orbital Engine	O/OrbitalEngine
Ore-Ida (part of Heinz)	O/Ore-IdapartofHeinz
Orient Craft	O/OrientCraft
Orient Express	O/OrientExpress
Orient Lines (part of Star Cruises)	O/OrientLinespartofStarCruises
Orient Overseas Container Line (see OOCL)	O/OrientOverseasContainerLineseeOOCL
Oriental Crest	O/OrientalCrest
Oriental Timber	O/OrientalTimber
Oriental Weavers	O/OrientalWeavers
Orion	O/Orion
Orion Pharma (see Orion)	O/OrionPharmaseeOrion
Orkut (part of Google)	O/OrkutpartofGoogle
Orly International	O/OrlyInternational
Ormat	O/Ormat
"Orrick, Herrington & Sutcliffe"	O/OrrickHerringtonSutcliffe
Oryx Natural Resources	O/OryxNaturalResources
Osem	O/Osem
Oshkosh B'Gosh	O/OshkoshBGosh
Osho Chemical Industries	O/OshoChemicalIndustries
OSLEG	O/OSLEG
Osram	O/Osram
OTE	O/OTE
Otis (part of United Technologies)	O/OtispartofUnitedTechnologies
Otokar	O/Otokar
Otto	O/Otto
Outdoor Cap	O/OutdoorCap
Outokumpu	O/Outokumpu
Owens Corning	O/OwensCorning
Oxford Industries	O/OxfordIndustries
Oxiana	O/Oxiana
Oxus Gold	O/OxusGold
P&H Mining (part of Joy Global)	P/PHMiningpartofJoyGlobal
P&O (part of Carnival)	P/POpartofCarnival
P&O Nedlloyd (joint venture between P&O and Royal Nedlloyd)	P/PONedlloydjointventurebetweenPOandRoyalNedlloyd
Pabst Brewing	P/PabstBrewing
Pacific Gas & Electric (see PG&E)	P/PacificGasElectricseePGE
Pacific Rim Mining	P/PacificRimMining
Pacific Steel	P/PacificSteel
Pacific Steel Casting	P/PacificSteelCasting
Pacificorp (part of Berkshire Hathaway)	P/PacificorppartofBerkshireHathaway
Paglas	P/Paglas
Pakistan Ordnance Factories	P/PakistanOrdnanceFactories
Pakistan Television	P/PakistanTelevision
Paladin Resources Ltd	P/PaladinResourcesLtd
Pall Mall Clothing	P/PallMallClothing
Paloma Industries	P/PalomaIndustries
Pan American Energy (joint venture BP & Bridas)	P/PanAmericanEnergyjointventureBPBridas
Pan Australian Resources	P/PanAustralianResources
Pan Macmillan	P/PanMacmillan
Pan Pacific Hotels (part of Tokyu)	P/PanPacificHotelspartofTokyu
Pan Pharmaceuticals	P/PanPharmaceuticals
Panamco (part of Coca-Cola FEMSA)	P/PanamcopartofCoca-ColaFEMSA
Panasonic (part of Matsushita)	P/PanasonicpartofMatsushita
Panhard	P/Panhard
Pansea Hotels & Resorts	P/PanseaHotelsResorts
Pará Pastoril e Agrícola (Pagrisa)	P/ParPastorileAgrcolaPagrisa
Paras Seeds	P/ParasSeeds
Parker Drilling	P/ParkerDrilling
ParknShop (part of Hutchison Whampoa)	P/ParknShoppartofHutchisonWhampoa
Parle Bisleri	P/ParleBisleri
Parmalat	P/Parmalat
"Parra, Rodríguez & Cavelier"	P/ParraRodrguezCavelier
Parsons	P/Parsons
Pasminco	P/Pasminco
Patagonia	P/Patagonia
Paul Reinhart	P/PaulReinhart
Paul Smith	P/PaulSmith
PDVSA (Petróleos de Venezuela)	P/PDVSAPetrleosdeVenezuela
Peabody Energy	P/PeabodyEnergy
Peacock Bay Environmental Services	P/PeacockBayEnvironmentalServices
Pearl Assurance (part of AMP Group)	P/PearlAssurancepartofAMPGroup
Pearl Continental	P/PearlContinental
Pearson	P/Pearson
PECD	P/PECD
Pechiney (part of Rio Tinto)	P/PechineypartofRioTinto
PECO Energy (part of Exelon)	P/PECOEnergypartofExelon
Peet's Coffee & Tea	P/PeetsCoffeeTea
Pemex	P/Pemex
Pengnian Industries	P/PengnianIndustries
Pennington Hardwoods	P/PenningtonHardwoods
Pentair	P/Pentair
Pentland Group	P/PentlandGroup
People Tree	P/PeopleTree
Pep Stores	P/PepStores
Pepco	P/Pepco
Pepe Jeans	P/PepeJeans
Pepkor	P/Pepkor
Pepsi Bottling Group	P/PepsiBottlingGroup
PepsiCo	P/PepsiCo
Perbadanan Bekalan Air Pulau Pinang (PBA)	P/PerbadananBekalanAirPulauPinangPBA
Perdue	P/Perdue
Perenco	P/Perenco
Perhutani	P/Perhutani
Perlos	P/Perlos
Pernod Ricard	P/PernodRicard
Perot Systems	P/PerotSystems
Perpetual	P/Perpetual
Perry Ellis	P/PerryEllis
Perry Manufacturing	P/PerryManufacturing
Persimmon	P/Persimmon
Pertamina	P/Pertamina
Perupetro	P/Perupetro
Petra Diamonds	P/PetraDiamonds
Petro-Canada	P/Petro-Canada
Petrobras	P/Petrobras
PetroChina	P/PetroChina
Petroecuador	P/Petroecuador
Petrolifera Petroleum	P/PetroliferaPetroleum
Petron	P/Petron
Petronas	P/Petronas
PetroSA	P/PetroSA
Petroterminal de Panama (PTP)	P/PetroterminaldePanamaPTP
Peugeot (see PSA Peugeot-Citroën)	P/PeugeotseePSAPeugeot-Citron
Pfizer	P/Pfizer
PG&E	P/PGE
Pharmacia (part of Pfizer)	P/PharmaciapartofPfizer
Phelps Dodge (part of Freeport-McMoRan)	P/PhelpsDodgepartofFreeport-McMoRan
Philex Mining	P/PhilexMining
Philip Morris (part of Altria)	P/PhilipMorrispartofAltria
Philippine Airlines	P/PhilippineAirlines
Philips Electronics (see Royal Philips Electronics)	P/PhilipsElectronicsseeRoyalPhilipsElectronics
Phillips Petroleum (see ConocoPhillips)	P/PhillipsPetroleumseeConocoPhillips
Phillips-Van Heusen	P/Phillips-VanHeusen
Phoenix Companies	P/PhoenixCompanies
Phytopharm	P/Phytopharm
Piaget (part of Richemont)	P/PiagetpartofRichemont
PicoPeta Simputers	P/PicoPetaSimputers
Pierre et Vacances	P/PierreetVacances
Pillsbury Winthrop Shaw Pittman	P/PillsburyWinthropShawPittman
Pinault-Printemps-Redoute (see PPR)	P/Pinault-Printemps-RedouteseePPR
Pinnacle West Capital	P/PinnacleWestCapital
Pioneer Natural Resources	P/PioneerNaturalResources
Pirelli	P/Pirelli
Pitney Bowes	P/PitneyBowes
Pitt Ohio Express	P/PittOhioExpress
Pittsburgh Pirates	P/PittsburghPirates
Pizano	P/Pizano
Pizza Hut (part of YUM!)	P/PizzaHutpartofYUM
Placer Dome (part of Barrick Gold)	P/PlacerDomepartofBarrickGold
Planet Hollywood	P/PlanetHollywood
Planetair	P/Planetair
Platinum Asset Management	P/PlatinumAssetManagement
Playtex (part of Hanesbrands)	P/PlaytexpartofHanesbrands
Plum Creek	P/PlumCreek
Pluspetrol	P/Pluspetrol
Plywood Tropics USA	P/PlywoodTropicsUSA
PNC Financial Services	P/PNCFinancialServices
PNM Resources	P/PNMResources
Polaroid	P/Polaroid
Polo Ralph Lauren	P/PoloRalphLauren
Polymerlatex	P/Polymerlatex
Polyphon Film	P/PolyphonFilm
Popeyes Chicken & Biscuits (part of AFC Enterprises)	P/PopeyesChickenBiscuitspartofAFCEnterprises
Posco	P/Posco
Postobón	P/Postobn
PotashCorp	P/PotashCorp
Potlatch	P/Potlatch
Pou Chen	P/PouChen
Powell Goldstein	P/PowellGoldstein
Power Corporation of Canada	P/PowerCorporationofCanada
Power Integrations	P/PowerIntegrations
Powergen (part of E.ON)	P/PowergenpartofEON
PPG	P/PPG
PPL	P/PPL
PPR (formerly Pinault-Printemps-Redoute)	P/PPRformerlyPinault-Printemps-Redoute
Pratt and Whitney (part of United Technologies)	P/PrattandWhitneypartofUnitedTechnologies
Praxair	P/Praxair
Praská teplárenská	P/Praskteplrensk
Precious Woods	P/PreciousWoods
Premcor (part of Valero Energy)	P/PremcorpartofValeroEnergy
Premier Foods	P/PremierFoods
Premier Oil	P/PremierOil
Pressalit Group	P/PressalitGroup
PricewaterhouseCoopers	P/PricewaterhouseCoopers
Primus Financial (part of Ford)	P/PrimusFinancialpartofFord
Primus Telecommunications	P/PrimusTelecommunications
Princess Cruises (part of Carnival)	P/PrincessCruisespartofCarnival
Printex	P/Printex
Proagro (part of Bayer)	P/ProagropartofBayer
Procter & Gamble	P/ProcterGamble
Prodem FFP	P/ProdemFFP
Prof-Media	P/Prof-Media
Professional Transit Management	P/ProfessionalTransitManagement
Progress Energy	P/ProgressEnergy
Progressive Enterprises	P/ProgressiveEnterprises
Progressive Insurance	P/ProgressiveInsurance
Prominvestors	P/Prominvestors
Pronaca	P/Pronaca
Protabaco	P/Protabaco
Protección (parte de Suramericana)	P/ProteccinpartedeSuramericana
Prototek	P/Prototek
Prudential Financial	P/PrudentialFinancial
Prudential plc	P/Prudentialplc
PSA Peugeot-Citroën	P/PSAPeugeot-Citron
PSEG (see Public Service Enterprise Group)	P/PSEGseePublicServiceEnterpriseGroup
PT Freeport Indonesia (see Freeport Indonesia)	P/PTFreeportIndonesiaseeFreeportIndonesia
PTT	P/PTT
"PTT Exploration and Production (PTTEP, part of PTT)"	P/PTTExplorationandProductionPTTEPpartofPTT
Public Service Enterprise Group	P/PublicServiceEnterpriseGroup
Public Warehousing Company (see PWC Logistics)	P/PublicWarehousingCompanyseePWCLogistics
Publicis	P/Publicis
Publix	P/Publix
Puma	P/Puma
Pumpkin Patch	P/PumpkinPatch
Punto de Salud	P/PuntodeSalud
Pupkewitz	P/Pupkewitz
Pura Foods	P/PuraFoods
Pura Vida	P/PuraVida
PVH (see Phillips-Van Heusen)	P/PVHseePhillips-VanHeusen
PWC Logistics	P/PWCLogistics
Q-Mac Electronics	Q/Q-MacElectronics
Qantas Airways	Q/QantasAirways
Qatar Airways	Q/QatarAirways
Qingdao Red Star Chemical Group	Q/QingdaoRedStarChemicalGroup
Qinghe Special Steel	Q/QingheSpecialSteel
Qingyang Chemical Industry	Q/QingyangChemicalIndustry
Quad/Graphics	Q/QuadGraphics
Quaker Chemical	Q/QuakerChemical
Qualytel Teleservices	Q/QualytelTeleservices
Quark	Q/Quark
Queiroz Galvão	Q/QueirozGalvo
Quilmes (part of InBev)	Q/QuilmespartofInBev
Química del Rey	Q/QumicadelRey
QVC (part of Liberty Media)	Q/QVCpartofLibertyMedia
R-Plus	R/R-Plus
R.Crusoe & Son	R/RCrusoeSon
R.J. McCarthy	R/RJMcCarthy
R.R. Donnelley & Sons	R/RRDonnelleySons
Rabobank	R/Rabobank
RadioShack	R/RadioShack
Radisson Seven Seas Cruises (part of Carlson)	R/RadissonSevenSeasCruisespartofCarlson
Raffles Hotels & Resorts	R/RafflesHotelsResorts
RAG	R/RAG
Raiffeisen Bank Aval (part of RZB Group)	R/RaiffeisenBankAvalpartofRZBGroup
Raiffeisen Zentralbank (see RZB Group)	R/RaiffeisenZentralbankseeRZBGroup
Rainbow Millennium Power	R/RainbowMillenniumPower
Raja Garuda Mas	R/RajaGarudaMas
Ramatex	R/Ramatex
Ramco Energy	R/RamcoEnergy
Ranbaxy Laboratories	R/RanbaxyLaboratories
Rand Merchant Bank (part of FirstRand Group)	R/RandMerchantBankpartofFirstRandGroup
Rand Water	R/RandWater
Randgold	R/Randgold
Random House	R/RandomHouse
Ranger Oil (part of Canadian Natural Resources)	R/RangerOilpartofCanadianNaturalResources
Rank	R/Rank
RAO-UES	R/RAO-UES
Rapaport Group	R/RapaportGroup
Ras (part of Allianz)	R/RaspartofAllianz
Rasfer International	R/RasferInternational
Rawlings Sporting Goods (part of K2)	R/RawlingsSportingGoodspartofK2
Raytheon	R/Raytheon
RC2	R/RC2
RCA (part of Thomson)	R/RCApartofThomson
RCF (Rashtriya Chemicals & Fertilizers)	R/RCFRashtriyaChemicalsFertilizers
RCM (part of Allianz)	R/RCMpartofAllianz
RD Corporation	R/RDCorporation
Reckitt Benckiser	R/ReckittBenckiser
Red Back Mining	R/RedBackMining
Red Eléctrica de España	R/RedElctricadeEspaa
Redcats (part of Pinault-Printemps-Redoute)	R/RedcatspartofPinault-Printemps-Redoute
Redkap	R/Redkap
Redstar Furniture	R/RedstarFurniture
Reebok (part of adidas)	R/Reebokpartofadidas
Reed Elsevier Group	R/ReedElsevierGroup
Reeves and Associates	R/ReevesandAssociates
Refco	R/Refco
Refinor	R/Refinor
Rehrig International	R/RehrigInternational
REI	R/REI
Reliance Industries	R/RelianceIndustries
Reliant Energy	R/ReliantEnergy
Remond	R/Remond
Rémy Cointreau	R/RmyCointreau
Renault	R/Renault
Renco	R/Renco
Rent-A-Center	R/Rent-A-Center
Rentokil Initial	R/RentokilInitial
Replacements Ltd.	R/ReplacementsLtd
Replay Jeans	R/ReplayJeans
Repsol YPF	R/RepsolYPF
Resona	R/Resona
Reuters	R/Reuters
Revlon	R/Revlon
Rexam	R/Rexam
Rey Banano del Pacífico	R/ReyBananodelPacfico
Reynolds American	R/ReynoldsAmerican
RGM International	R/RGMInternational
RGS	R/RGS
Rheinmetall	R/Rheinmetall
Rhino Minerals (part of Imerys)	R/RhinoMineralspartofImerys
RHM	R/RHM
Rhodia	R/Rhodia
Rica City Hotels	R/RicaCityHotels
Richards Bay Minerals (joint venture Rio Tinto & BHP Billiton)	R/RichardsBayMineralsjointventureRioTintoBHPBilliton
Richemont	R/Richemont
Ricoh	R/Ricoh
Riddell	R/Riddell
Riggs Bank (now part of PNC Financial Services)	R/RiggsBanknowpartofPNCFinancialServices
Rimbunan Hijau	R/RimbunanHijau
Rio Algom (part of BHP Billiton)	R/RioAlgompartofBHPBilliton
Rio Grande Foods	R/RioGrandeFoods
Rio Tinto	R/RioTinto
Rio Tinto Alcan (part of Rio Tinto)	R/RioTintoAlcanpartofRioTinto
Rio Tuba Nickel Mining	R/RioTubaNickelMining
Rip Curl	R/RipCurl
Ripley	R/Ripley
Rismar Daewoo Apparel (joint venture Rismar Transindo & Daewoo International)	R/RismarDaewooAppareljointventureRismarTransindoDaewooInternational
Rite Aid	R/RiteAid
RITES	R/RITES
River Island (part of Lewis Trust)	R/RiverIslandpartofLewisTrust
Rivolier	R/Rivolier
RJ Reynolds (part of Reynolds American)	R/RJReynoldspartofReynoldsAmerican
RMC	R/RMC
RNK Capital	R/RNKCapital
RO Defence (part of BAE Systems)	R/RODefencepartofBAESystems
Robbins Timber	R/RobbinsTimber
Robert Stephen Holdings	R/RobertStephenHoldings
Rocawear	R/Rocawear
Roche	R/Roche
Rocketdyne (part of Boeing)	R/RocketdynepartofBoeing
Rocky Mountain Chocolate Factory	R/RockyMountainChocolateFactory
Roda Group	R/RodaGroup
Rodale	R/Rodale
Rohm	R/Rohm
Rohm & Haas	R/RohmHaas
Rolex	R/Rolex
Rolls-Royce plc	R/Rolls-Royceplc
Roman Originals	R/RomanOriginals
Romark Laboratories	R/RomarkLaboratories
Roots	R/Roots
Rosneft	R/Rosneft
Ross Stores	R/RossStores
Rössing Uranium	R/RssingUranium
Rosy Blue	R/RosyBlue
Roth Capital Partners	R/RothCapitalPartners
Rougier	R/Rougier
Roundabout	R/Roundabout
Rowan Companies	R/RowanCompanies
Roxel (joint venture MBDA & SNPE)	R/RoxeljointventureMBDASNPE
Royal & SunAlliance	R/RoyalSunAlliance
Royal Ahold (see Ahold)	R/RoyalAholdseeAhold
Royal Asscher	R/RoyalAsscher
Royal Bank of Canada	R/RoyalBankofCanada
Royal Bank of Scotland	R/RoyalBankofScotland
Royal Blue	R/RoyalBlue
Royal Boskalis Westminster	R/RoyalBoskalisWestminster
Royal Brunei Airlines	R/RoyalBruneiAirlines
Royal Caribbean Cruises	R/RoyalCaribbeanCruises
Royal Dutch / Shell (see Shell)	R/RoyalDutchShellseeShell
Royal Mail	R/RoyalMail
Royal Nedlloyd	R/RoyalNedlloyd
Royal Numico	R/RoyalNumico
Royal Ordnance (see RO Defence)	R/RoyalOrdnanceseeRODefence
Royal Philips Electronics	R/RoyalPhilipsElectronics
Royal Vendex KBB	R/RoyalVendexKBB
Royalco Resources	R/RoyalcoResources
Rubicon	R/Rubicon
Rubie's Costume	R/RubiesCostume
Ruder Finn	R/RuderFinn
RUSAL	R/RUSAL
Russell (part of Berkshire Hathaway)	R/RussellpartofBerkshireHathaway
Russia Online	R/RussiaOnline
Russian Railways	R/RussianRailways
Rust-Oleum	R/Rust-Oleum
RWE	R/RWE
Ryanair	R/Ryanair
Ryland	R/Ryland
RZB Group	R/RZBGroup
S-Oil	S/S-Oil
Saab Automobile (part of General Motors)	S/SaabAutomobilepartofGeneralMotors
Saab Avitronics (joint venture Saab Group & Grintek)	S/SaabAvitronicsjointventureSaabGroupGrintek
Saab Group	S/SaabGroup
Saba (part of Dole)	S/SabapartofDole
SABMiller	S/SABMiller
Saceites	S/Saceites
Sadia	S/Sadia
Safeco	S/Safeco
Safeway (USA)	S/SafewayUSA
Safeway UK (part of Morrisons)	S/SafewayUKpartofMorrisons
Safmarine (part of A.P. Moller-Maersk)	S/SafmarinepartofAPMoller-Maersk
Safra	S/Safra
Safran	S/Safran
Saga Sports	S/SagaSports
Sagawa Express	S/SagawaExpress
Sage	S/Sage
Sagep	S/Sagep
Sainsbury	S/Sainsbury
Saint-Gobain	S/Saint-Gobain
"Sakhalin Energy (joint venture Shell, Mitsui, & Mitsubishi)"	S/SakhalinEnergyjointventureShellMitsuiMitsubishi
Salcomp	S/Salcomp
Salesforce.com	S/Salesforcecom
Sally Hansen	S/SallyHansen
Sam's Club (part of Wal-Mart)	S/SamsClubpartofWal-Mart
Samancor	S/Samancor
Sambhav Gems	S/SambhavGems
Sameer Group	S/SameerGroup
Samgong	S/Samgong
Samling	S/Samling
Sampoerna	S/Sampoerna
Samsonite	S/Samsonite
Samsung	S/Samsung
San Miguel Beer (part of San Miguel Corporation)	S/SanMiguelBeerpartofSanMiguelCorporation
San Miguel Corporation	S/SanMiguelCorporation
Sandals	S/Sandals
Sandline International	S/SandlineInternational
Sandvik	S/Sandvik
Sanlam	S/Sanlam
Sanmar	S/Sanmar
Sanmina-SCI	S/Sanmina-SCI
Sanofi Pasteur (part of Sanofi-Aventis)	S/SanofiPasteurpartofSanofi-Aventis
Sanofi-Aventis	S/Sanofi-Aventis
Sanofi-Synthélabo (now part of Sanofi-Aventis)	S/Sanofi-SynthlabonowpartofSanofi-Aventis
Sanoflore	S/Sanoflore
Sanpaolo IMI (part of Intesa Sanpaolo)	S/SanpaoloIMIpartofIntesaSanpaolo
Santa Bárbara (part of General Dynamics)	S/SantaBrbarapartofGeneralDynamics
Santa Sweets (part of Ag-Mart Produce)	S/SantaSweetspartofAg-MartProduce
Santander	S/Santander
Santos	S/Santos
Sanyo	S/Sanyo
SAP	S/SAP
Sappi	S/Sappi
SAPREF (joint venture Shell & BP)	S/SAPREFjointventureShellBP
Sara Lee	S/SaraLee
Sarantis	S/Sarantis
SAS (Scandinavian Airlines)	S/SASScandinavianAirlines
Sasol	S/Sasol
Satho Hazir Giyim	S/SathoHazirGiyim
Satyam	S/Satyam
Saudi Aramco	S/SaudiAramco
Saudi Lighting	S/SaudiLighting
Saudi Refining	S/SaudiRefining
SAUR (part of Bouygues)	S/SAURpartofBouygues
SBC Communications (now AT&T)	S/SBCCommunicationsnowATT
SC Johnson	S/SCJohnson
SCA	S/SCA
Scania	S/Scania
Scharffen Berger Chocolate	S/ScharffenBergerChocolate
Schenker	S/Schenker
Schering-Plough	S/Schering-Plough
Schick-Wilkinson Sword (part of Energizer)	S/Schick-WilkinsonSwordpartofEnergizer
Schindler	S/Schindler
Schlumberger	S/Schlumberger
Schneider	S/Schneider
Schroders	S/Schroders
Schwab (see Charles Schwab)	S/SchwabseeCharlesSchwab
Scomi	S/Scomi
Scotiabank	S/Scotiabank
Scottish and Southern Energy	S/ScottishandSouthernEnergy
Scottish Power	S/ScottishPower
Scottish Water	S/ScottishWater
Scotts	S/Scotts
SDM (Sociedade de Desenvolvimento Mineiro de Angola) (joint venture Odebrecht & Endiama)	S/SDMSociedadedeDesenvolvimentoMineirodeAngolajointventureOdebrechtEndiama
Sea Containers	S/SeaContainers
Seaboard	S/Seaboard
Seabourn Cruise Line (part of Carnival)	S/SeabournCruiseLinepartofCarnival
Seachem Tankers (part of Odfjell)	S/SeachemTankerspartofOdfjell
Seagate Technology	S/SeagateTechnology
Sealed Air	S/SealedAir
Sean John Clothing	S/SeanJohnClothing
Seara Alimentos	S/SearaAlimentos
Sears	S/Sears
Seattle's Best	S/SeattlesBest
SEB	S/SEB
Secil - Companhia Geral de Cal e Cimento	S/Secil-CompanhiaGeraldeCaleCimento
Secure Computing	S/SecureComputing
Securicor (now Group 4 Securicor)	S/SecuricornowGroup4Securicor
Securitas	S/Securitas
Sedapal	S/Sedapal
See's Candies	S/SeesCandies
SEFAC (part of Vasto Legno)	S/SEFACpartofVastoLegno
Sega	S/Sega
SEGUROC	S/SEGUROC
Seguros Bolívar	S/SegurosBolvar
SEH America (part of Shin-Etsu Group)	S/SEHAmericapartofShin-EtsuGroup
Seiko	S/Seiko
Sekem	S/Sekem
Select	S/Select
SEMAPA (Servicio Municipal de Agua Potable y Alcantarillado)	S/SEMAPAServicioMunicipaldeAguaPotableyAlcantarillado
Sempra Energy	S/SempraEnergy
Semtech	S/Semtech
Senao	S/Senao
Serena Hotels	S/SerenaHotels
Serendip Productions	S/SerendipProductions
Serenísima (Mastellone Hermanos)	S/SerensimaMastelloneHermanos
Serono	S/Serono
Service Merchandise	S/ServiceMerchandise
ServiceMaster	S/ServiceMaster
Seven Up/RC Bottling Co. of Southern California (part of Dr Pepper/Seven Up Bottling Group)	S/SevenUpRCBottlingCoofSouthernCaliforniapartofDrPepperSevenUpBottlingGroup
Seventh Generation	S/SeventhGeneration
Severn Trent	S/SevernTrent
Sfera	S/Sfera
SH&E (Simat Helliesen & Eichner)	S/SHESimatHelliesenEichner
Shaanxi Huadian	S/ShaanxiHuadian
Shahi Textiles	S/ShahiTextiles
Shamrock Manufacturing	S/ShamrockManufacturing
Shanda Interactive Entertainment	S/ShandaInteractiveEntertainment
Shanda Network Development	S/ShandaNetworkDevelopment
Shandong Gold Group	S/ShandongGoldGroup
Shandong Weiqiao Pioneering	S/ShandongWeiqiaoPioneering
Shanghai Automobile Industry Corporation (SAIC)	S/ShanghaiAutomobileIndustryCorporationSAIC
Shanghai Chenxing Electronics	S/ShanghaiChenxingElectronics
Shanghai General Motors	S/ShanghaiGeneralMotors
Shanghai Huashang Clothing	S/ShanghaiHuashangClothing
Shanghai Jingxuan Plastic Products	S/ShanghaiJingxuanPlasticProducts
Shanghai Pudong Development Bank	S/ShanghaiPudongDevelopmentBank
Shanghai Yongquan Shoes	S/ShanghaiYongquanShoes
Shangri-La Hotel	S/Shangri-LaHotel
Shanks	S/Shanks
Shaoxing Mishuai Dress Making	S/ShaoxingMishuaiDressMaking
Sharp	S/Sharp
Shaw Communications	S/ShawCommunications
Shaw Group	S/ShawGroup
Shaw Industries (part of Berkshire Hathaway)	S/ShawIndustriespartofBerkshireHathaway
Shaw's Supermarkets (part of Sainsbury)	S/ShawsSupermarketspartofSainsbury
Shelby Group	S/ShelbyGroup
Shell	S/Shell
Shelman	S/Shelman
Shenhua Group	S/ShenhuaGroup
Shenzhen Water	S/ShenzhenWater
Sheraton (part of Starwood Hotels)	S/SheratonpartofStarwoodHotels
Sherwin-Williams	S/Sherwin-Williams
Shikoku Electric Power	S/ShikokuElectricPower
Shin	S/Shin
Shin Nihon	S/ShinNihon
Shin-Etsu Group	S/Shin-EtsuGroup
Shinhan Bank	S/ShinhanBank
Shire	S/Shire
SHM Smith Hodgkinson	S/SHMSmithHodgkinson
Shoprite	S/Shoprite
Shougang	S/Shougang
Shree Cement	S/ShreeCement
Shui On	S/ShuiOn
Siam Cement	S/SiamCement
Siam Commercial Bank	S/SiamCommercialBank
Sibeka (part of Umicore)	S/SibekapartofUmicore
Siberian Urals Aluminium Company (see SUAL)	S/SiberianUralsAluminiumCompanyseeSUAL
Sida International	S/SidaInternational
Siderúrgica Tultitlán	S/SiderrgicaTultitln
Sidley Austin Brown & Wood	S/SidleyAustinBrownWood
Siegwart	S/Siegwart
Siemens	S/Siemens
Sierra Leone Diamond	S/SierraLeoneDiamond
Sigla	S/Sigla
Signal International	S/SignalInternational
Signet	S/Signet
Silver Shadow	S/SilverShadow
Silver Standard	S/SilverStandard
Silver Star Group	S/SilverStarGroup
Silverjet	S/Silverjet
Silverlit	S/Silverlit
Silversea Cruises	S/SilverseaCruises
Silverstein Properties	S/SilversteinProperties
Simat Helliesen & Eichner (see SH&E)	S/SimatHelliesenEichnerseeSHE
Simon Lévelt	S/SimonLvelt
Simon Property	S/SimonProperty
Sims Group	S/SimsGroup
SINA	S/SINA
Sinar Mas Group	S/SinarMasGroup
Sinclair Broadcast Group	S/SinclairBroadcastGroup
Sinclair Roche & Temperley (part of Stephenson Harwood)	S/SinclairRocheTemperleypartofStephensonHarwood
Singapore Airlines	S/SingaporeAirlines
Singapore Food Industries	S/SingaporeFoodIndustries
Singapore Petroleum	S/SingaporePetroleum
Singapore Technologies (see ST Engineering)	S/SingaporeTechnologiesseeSTEngineering
Singapore Telecommunications	S/SingaporeTelecommunications
Singer (part of Classic Medallics)	S/SingerpartofClassicMedallics
Sino Gold	S/SinoGold
Sino Mining International (part of Sino Gold)	S/SinoMiningInternationalpartofSinoGold
Sinohydro	S/Sinohydro
Sinomem	S/Sinomem
Sinopec	S/Sinopec
Síntesis	S/Sntesis
Sipcam-Oxon	S/Sipcam-Oxon
Sipma	S/Sipma
Site Concrete	S/SiteConcrete
Sitec Aerospace (part of Accuron)	S/SitecAerospacepartofAccuron
Sjunde AP-fonden	S/SjundeAP-fonden
SK Corporation	S/SKCorporation
Skanska	S/Skanska
Skechers	S/Skechers
SkillSoft	S/SkillSoft
SKS (Swayam Krishi Sangam)	S/SKSSwayamKrishiSangam
Skye Resources	S/SkyeResources
Skype (part of eBay)	S/SkypepartofeBay
Slough Estates	S/SloughEstates
Smith & Nephew	S/SmithNephew
Smith and Wesson	S/SmithandWesson
Smith Barney (part of Citigroup)	S/SmithBarneypartofCitigroup
Smithfield Foods	S/SmithfieldFoods
Smiths City	S/SmithsCity
Smiths Group	S/SmithsGroup
Smurfit Kappa Cartón de Colombia (part of Smurfit Kappa)	S/SmurfitKappaCartndeColombiapartofSmurfitKappa
Smurfit-Stone	S/Smurfit-Stone
Snamprogetti (part of ENI)	S/SnamprogettipartofENI
SNC-Lavalin	S/SNC-Lavalin
SNCF (Société Nationale des Chemins de Fer)	S/SNCFSocitNationaledesCheminsdeFer
Snecma (part of Safran)	S/SnecmapartofSafran
SNPC (see Société Nationale des Pétroles du Congo)	S/SNPCseeSocitNationaledesPtrolesduCongo
SNPE	S/SNPE
Sobel	S/Sobel
SOCAR (see State Oil Company of Azerbaijan)	S/SOCARseeStateOilCompanyofAzerbaijan
Socatur (Société camerounaise de transports urbains)	S/SocaturSocitcamerounaisedetransportsurbains
Société Générale	S/SocitGnrale
Société Générale de Surveillance (SGS)	S/SocitGnraledeSurveillanceSGS
Société Minière de Bakwanga (see MIBA)	S/SocitMiniredeBakwangaseeMIBA
Société Nationale des Pétroles du Congo (SNPC)	S/SocitNationaledesPtrolesduCongoSNPC
Sodexho	S/Sodexho
SODIAM Sarl (part of Endiama)	S/SODIAMSarlpartofEndiama
Sodiama International (joint venture Lev Leviev & Endiama)	S/SodiamaInternationaljointventureLevLevievEndiama
Soekor	S/Soekor
Sofiyska Voda	S/SofiyskaVoda
Sogea	S/Sogea
Sohu.com	S/Sohucom
Sojitz	S/Sojitz
Sol Meliá	S/SolMeli
Solar Millenium	S/SolarMillenium
Solargenix	S/Solargenix
SolarWorld	S/SolarWorld
Solectron	S/Solectron
Solid Waste Technologies	S/SolidWasteTechnologies
Solomon Associates (part of AIG)	S/SolomonAssociatespartofAIG
Solutia	S/Solutia
Solvay	S/Solvay
Somerfield	S/Somerfield
Somers Building Maintenance (SBM)	S/SomersBuildingMaintenanceSBM
Somika (Société Miniere du Katanga)	S/SomikaSocitMiniereduKatanga
Sonae	S/Sonae
Sonangol	S/Sonangol
Sonatrach	S/Sonatrach
Songyuan City Ningjiang District Yadahong Industrial Park	S/SongyuanCityNingjiangDistrictYadahongIndustrialPark
Sonofon (part of Telenor)	S/SonofonpartofTelenor
Sony	S/Sony
Sony Ericsson (joint venture Sony & Ericsson)	S/SonyEricssonjointventureSonyEricsson
South African Airways	S/SouthAfricanAirways
Southern California Edison (part of Edison International)	S/SouthernCaliforniaEdisonpartofEdisonInternational
Southern Company	S/SouthernCompany
Southern Cross	S/SouthernCross
"Southern Peru Copper (joint venture Grupo México, Cerro Trading, Freeport-McMoRan)"	S/SouthernPeruCopperjointventureGrupoMxicoCerroTradingFreeport-McMoRan
Southern Range Nyanza	S/SouthernRangeNyanza
Southern Water	S/SouthernWater
SouthernEra Diamonds	S/SouthernEraDiamonds
Southwest Airlines	S/SouthwestAirlines
Souza Cruz (part of British American Tobacco)	S/SouzaCruzpartofBritishAmericanTobacco
Sovcomflot	S/Sovcomflot
Special Operations Consulting-Security Management Group (SOC-SMG)	S/SpecialOperationsConsulting-SecurityManagementGroupSOC-SMG
Speedo (part of Pentland Group)	S/SpeedopartofPentlandGroup
Spilan	S/Spilan
Spirent	S/Spirent
Splav	S/Splav
Spolana	S/Spolana
Sport-Elec	S/Sport-Elec
Sports Authority	S/SportsAuthority
Sprint Nextel	S/SprintNextel
Square Fashions (part of Square Group)	S/SquareFashionspartofSquareGroup
Square Group	S/SquareGroup
Square Pharmaceuticals (part of Square Group)	S/SquarePharmaceuticalspartofSquareGroup
SriLankan Airlines	S/SriLankanAirlines
SSL International	S/SSLInternational
ST Engineering (Singapore Technologies Engineering)	S/STEngineeringSingaporeTechnologiesEngineering
"ST Kinetics (Singapore Technologies Kinetics, part of ST Engineering)"	S/STKineticsSingaporeTechnologiesKineticspartofSTEngineering
ST Microelectronics	S/STMicroelectronics
St. Ives	S/StIves
St. Paul Travelers	S/StPaulTravelers
Stagecoach Group	S/StagecoachGroup
Stallion Garments	S/StallionGarments
Stanbic Bank	S/StanbicBank
Standard & Poor's (part of McGraw Hill)	S/StandardPoorspartofMcGrawHill
Standard Bank	S/StandardBank
Standard Bank London (part of Standard Bank)	S/StandardBankLondonpartofStandardBank
Standard Chartered	S/StandardChartered
Standard Fruit (see Dole)	S/StandardFruitseeDole
Standard Life	S/StandardLife
Standard Pacific	S/StandardPacific
Stanley Works	S/StanleyWorks
Staples	S/Staples
Star Cruises	S/StarCruises
Starbucks	S/Starbucks
Starcom MediaVest (part of Publicis)	S/StarcomMediaVestpartofPublicis
Starmet	S/Starmet
Starwood Hotels	S/StarwoodHotels
State Bank of India	S/StateBankofIndia
State Farm Insurance	S/StateFarmInsurance
State Grid Corporation of China	S/StateGridCorporationofChina
State Oil Company of Azerbaijan (SOCAR)	S/StateOilCompanyofAzerbaijanSOCAR
State Street	S/StateStreet
Statoil	S/Statoil
STEAG	S/STEAG
Steelcase	S/Steelcase
Steilmann	S/Steilmann
Steinecker	S/Steinecker
Stella Artois (part of InBev)	S/StellaArtoispartofInBev
Stella International [Taiwan]	S/StellaInternationalTaiwan
Sterling (part of Signet)	S/SterlingpartofSignet
Sterlite Industries (part of Vedanta Resources)	S/SterliteIndustriespartofVedantaResources
Steve & Barry's	S/SteveBarrys
Steyr (part of Steyr Mannlicher)	S/SteyrpartofSteyrMannlicher
Steyr Mannlicher	S/SteyrMannlicher
Stihl	S/Stihl
Stockland	S/Stockland
Stockline Plastics (part of ICL Plastics)	S/StocklinePlasticspartofICLPlastics
Stolt Nielsen	S/StoltNielsen
Stonyfield Farm	S/StonyfieldFarm
Stora Enso	S/StoraEnso
Storebrand	S/Storebrand
Straits Resources	S/StraitsResources
Strauss	S/Strauss
Street One	S/StreetOne
Stride Rite	S/StrideRite
Stroytransgaz	S/Stroytransgaz
SUAL	S/SUAL
Suashish Diamonds	S/SuashishDiamonds
Subocol	S/Subocol
Suburban Guns	S/SuburbanGuns
Subway	S/Subway
Sudapet	S/Sudapet
Suessen	S/Suessen
Suez	S/Suez
Sullivan & Cromwell	S/SullivanCromwell
Sumalindo Lestari Jaya	S/SumalindoLestariJaya
Sumitomo Chemical (part of Sumitomo Group)	S/SumitomoChemicalpartofSumitomoGroup
Sumitomo Electric Industries (part of Sumitomo Group)	S/SumitomoElectricIndustriespartofSumitomoGroup
Sumitomo Group	S/SumitomoGroup
Sumitomo Life Insurance (part of Sumitomo Group)	S/SumitomoLifeInsurancepartofSumitomoGroup
Sumitomo Metal Industries (part of Sumitomo Group)	S/SumitomoMetalIndustriespartofSumitomoGroup
Sumitomo Metal Mining (part of Sumitomo Group)	S/SumitomoMetalMiningpartofSumitomoGroup
Sumitomo Mitsui Banking (part of Sumitomo Group)	S/SumitomoMitsuiBankingpartofSumitomoGroup
Sun Hung Kai Properties	S/SunHungKaiProperties
Sun Microsystems	S/SunMicrosystems
Sun Newspaper (UK) (part of News Corp)	S/SunNewspaperUKpartofNewsCorp
Sun Television Cybernetworks	S/SunTelevisionCybernetworks
Sun Wah	S/SunWah
Suncoast Casino and Entertainment World (part of Tsogo Sun)	S/SuncoastCasinoandEntertainmentWorldpartofTsogoSun
Suncor	S/Suncor
Suncorp-Metway	S/Suncorp-Metway
Sunoco	S/Sunoco
SunPower	S/SunPower
Suntech Power	S/SuntechPower
SunTrust Banks	S/SunTrustBanks
Sunways	S/Sunways
Superdrug (part of Hutchison Whampoa)	S/SuperdrugpartofHutchisonWhampoa
Supermercados San Francisco	S/SupermercadosSanFrancisco
Supervalu	S/Supervalu
Sural	S/Sural
Suramericana	S/Suramericana
Surgutneftegas	S/Surgutneftegas
Susalud (parte de Suramericana)	S/SusaludpartedeSuramericana
Sutton Resources	S/SuttonResources
Suzuki	S/Suzuki
Swarovski	S/Swarovski
Swatch	S/Swatch
Swayam Krishi Sangam (see SKS)	S/SwayamKrishiSangamseeSKS
Swedbank	S/Swedbank
Swedish Post Office	S/SwedishPostOffice
Swedish Television	S/SwedishTelevision
Swift & Company	S/SwiftCompany
Swift (co-operative)	S/Swiftco-operative
Swire Group	S/SwireGroup
Swiss Re	S/SwissRe
Switcher	S/Switcher
Sygen	S/Sygen
Syncrude	S/Syncrude
Syndicate Bank	S/SyndicateBank
Syngenta	S/Syngenta
Système-U	S/Systme-U
T & T Supermarket	T/TTSupermarket
T-Mobile (part of Deutsche Telekom)	T/T-MobilepartofDeutscheTelekom
Taco Bell (part of YUM!)	T/TacoBellpartofYUM
Taiheiyo	T/Taiheiyo
Taijinbao (see Cal-Comp Electronics)	T/TaijinbaoseeCal-CompElectronics
Tainan Enterprises	T/TainanEnterprises
Taipower	T/Taipower
Taiwan Cement Group	T/TaiwanCementGroup
Taixing Glycerin Factory	T/TaixingGlycerinFactory
Takara Tomy	T/TakaraTomy
Takeda Pharmaceutical	T/TakedaPharmaceutical
Talal Abu-Ghazaleh	T/TalalAbu-Ghazaleh
Talbots	T/Talbots
Talisman	T/Talisman
Tamega	T/Tamega
Tanzania Pharmaceutical Industries	T/TanzaniaPharmaceuticalIndustries
TAP Pharmaceuticals (joint venture Abbott Laboratories & Takeda Pharmaceutical)	T/TAPPharmaceuticalsjointventureAbbottLaboratoriesTakedaPharmaceutical
Tapas La Libertad	T/TapasLaLibertad
Target	T/Target
Tarkwa Goldfields	T/TarkwaGoldfields
Tarrant Apparel	T/TarrantApparel
Taser	T/Taser
Tata Consultancy Services (part of Tata Group)	T/TataConsultancyServicespartofTataGroup
Tata Group	T/TataGroup
Tata Iron and Steel (TISCO) (part of Tata Group)	T/TataIronandSteelTISCOpartofTataGroup
Tata Motors (part of Tata Group)	T/TataMotorspartofTataGroup
Tata Steel (see Tata Iron and Steel)	T/TataSteelseeTataIronandSteel
Tata Tea (part of Tata Group)	T/TataTeapartofTataGroup
Tate & Lyle	T/TateLyle
Tatneft	T/Tatneft
Taylor Wimpey	T/TaylorWimpey
TBM Hardwoods	T/TBMHardwoods
Tchibo	T/Tchibo
TCIL (see Telecommunications Consultants India Ltd.)	T/TCILseeTelecommunicationsConsultantsIndiaLtd
TCL Corporation	T/TCLCorporation
TD Bank (see Toronto-Dominion Bank)	T/TDBankseeToronto-DominionBank
TDK	T/TDK
TEA Computers	T/TEAComputers
Techint	T/Techint
Techneglas	T/Techneglas
Technip Coflexip	T/TechnipCoflexip
Teck Cominco	T/TeckCominco
Tecnosol	T/Tecnosol
TECO Energy	T/TECOEnergy
Ted Baker	T/TedBaker
Teddy Exports	T/TeddyExports
Teekanne	T/Teekanne
Teijin	T/Teijin
Teikoku Oil	T/TeikokuOil
Tekken	T/Tekken
Telecom Italia (part of Pirelli)	T/TelecomItaliapartofPirelli
Telecommunications Consultants India Ltd. (TCIL)	T/TelecommunicationsConsultantsIndiaLtdTCIL
Telefónica	T/Telefnica
Teléfonos de México (see Telmex)	T/TelfonosdeMxicoseeTelmex
Telekom Malaysia	T/TelekomMalaysia
Telemadrid	T/Telemadrid
Telemundo	T/Telemundo
Telenor	T/Telenor
Téléperformance	T/Tlperformance
Teleservice	T/Teleservice
Telia	T/Telia
TeliaSonera	T/TeliaSonera
Telkom	T/Telkom
Telmex	T/Telmex
Telstra	T/Telstra
Telus	T/Telus
Tembec	T/Tembec
Temple-Inland	T/Temple-Inland
Tenaga Nasional	T/TenagaNasional
Tenedora Nemak (part of Ford)	T/TenedoraNemakpartofFord
Tenet Healthcare	T/TenetHealthcare
Tenke Mining	T/TenkeMining
Teradyne	T/Teradyne
Teragren	T/Teragren
Terex	T/Terex
Terumo	T/Terumo
Tesco	T/Tesco
Tesco Mobile (joint venture Tesco & Telefónica)	T/TescoMobilejointventureTescoTelefnica
Tesoro	T/Tesoro
Tessenderlo	T/Tessenderlo
Tetley (part of Tata Tea)	T/TetleypartofTataTea
Tetra Laval	T/TetraLaval
Tetra Pak (part of Tetra Laval)	T/TetraPakpartofTetraLaval
Tetra Technologies	T/TetraTechnologies
Texaco (part of Chevron)	T/TexacopartofChevron
Texas Instruments	T/TexasInstruments
Texas Land & Cattle Steakhouse (part of Lone Star Steakhouse)	T/TexasLandCattleSteakhousepartofLoneStarSteakhouse
Texchem	T/Texchem
Texport Overseas	T/TexportOverseas
Textil Santanderina	T/TextilSantanderina
Textiles KN de Oriente	T/TextilesKNdeOriente
Textron	T/Textron
TF1	T/TF1
TH Drilling	T/THDrilling
Thai Airways International	T/ThaiAirwaysInternational
Thales	T/Thales
Thames Water (part of RWE)	T/ThamesWaterpartofRWE
The Warehouse (see Warehouse)	T/TheWarehouseseeWarehouse
Theo Fennell	T/TheoFennell
Thermax	T/Thermax
Thomas Cook	T/ThomasCook
Thomson	T/Thomson
Thomson Holidays (part of TUI)	T/ThomsonHolidayspartofTUI
Thor Chemicals	T/ThorChemicals
Thyssen Henschel	T/ThyssenHenschel
ThyssenKrupp	T/ThyssenKrupp
TIAA-CREF	T/TIAA-CREF
Tiandi Group	T/TiandiGroup
Tibotec (part of Johnson & Johnson)	T/TibotecpartofJohnsonJohnson
Tidewater	T/Tidewater
Tiffany	T/Tiffany
Tiger Brands	T/TigerBrands
Tiger International Resources	T/TigerInternationalResources
Tilcon (part of Oldcastle Materials which is part of CRH)	T/TilconpartofOldcastleMaterialswhichispartofCRH
Tim Maxitel (part of Telecom Italia)	T/TimMaxitelpartofTelecomItalia
Timberland	T/Timberland
Timbmet	T/Timbmet
Time Warner	T/TimeWarner
Times Newspapers (UK) (part of News Corp)	T/TimesNewspapersUKpartofNewsCorp
Timoney Technology	T/TimoneyTechnology
Tintoretto	T/Tintoretto
Tiomin Resources	T/TiominResources
Tipco Asphalt	T/TipcoAsphalt
TISCO (see Tata Iron and Steel)	T/TISCOseeTataIronandSteel
Titan (now L-3 Titan)	T/TitannowL-3Titan
Titan Cement	T/TitanCement
TJ Maxx (part of TJX)	T/TJMaxxpartofTJX
TJX	T/TJX
Tlocznia Metali Pressta (TM Pressta)	T/TloczniaMetaliPresstaTMPressta
TNK-BP	T/TNK-BP
TNT (part of TPG)	T/TNTpartofTPG
Tohoku Electric Power	T/TohokuElectricPower
Tokio Marine & Nichido (part of Millea)	T/TokioMarineNichidopartofMillea
Tokyo Electric Power	T/TokyoElectricPower
Tokyo Gas	T/TokyoGas
Toll Brothers	T/TollBrothers
Tom Online	T/TomOnline
Tom's of Maine	T/TomsofMaine
Tomkins	T/Tomkins
Tommy Hilfiger	T/TommyHilfiger
Tongaat Hulett	T/TongaatHulett
Tongling Chemical Industry	T/TonglingChemicalIndustry
TOP-TOY	T/TOP-TOY
Topper (part of Alpargatas)	T/TopperpartofAlpargatas
Topshop (part of Arcadia)	T/TopshoppartofArcadia
Toronto Ventures Incorporated (see TVI Pacific)	T/TorontoVenturesIncorporatedseeTVIPacific
Toronto-Dominion Bank	T/Toronto-DominionBank
Tosco	T/Tosco
Toshiba	T/Toshiba
Total	T/Total
Total Indonesie (part of Total)	T/TotalIndonesiepartofTotal
Total Intelligence	T/TotalIntelligence
Tourism Product Development Company (TPDCO)	T/TourismProductDevelopmentCompanyTPDCO
Tournigan Gold	T/TourniganGold
Tower Semiconductor	T/TowerSemiconductor
Toymaster	T/Toymaster
Toyo Gosei	T/ToyoGosei
Toyota	T/Toyota
Toys R Us	T/ToysRUs
TPAO (see Turkish Petroleum)	T/TPAOseeTurkishPetroleum
TPG	T/TPG
TPG (Texas Pacific)	T/TPGTexasPacific
Tractebel (part of Suez)	T/TractebelpartofSuez
Trafigura Beheer	T/TrafiguraBeheer
Traidcraft	T/Traidcraft
Trans Hex	T/TransHex
Trans Thai-Malaysia (joint venture PTT and Petronas)	T/TransThai-MalaysiajointventurePTTandPetronas
Trans-Resources	T/Trans-Resources
TransAlta	T/TransAlta
TransAtlantic Petroleum	T/TransAtlanticPetroleum
Transco (part of National Grid)	T/TranscopartofNationalGrid
Transdev (part of Caisse des Dépôts)	T/TransdevpartofCaissedesDpts
Transener	T/Transener
Transierra	T/Transierra
Transport Corporation of India	T/TransportCorporationofIndia
Transportes M&S	T/TransportesMS
Transredes	T/Transredes
Transurban	T/Transurban
Travelex	T/Travelex
Trendwest Resorts (part of Wyndham)	T/TrendwestResortspartofWyndham
Tribes Travel	T/TribesTravel
Tribune Company	T/TribuneCompany
Trico Products (part of Tomkins)	T/TricoProductspartofTomkins
Trigem	T/Trigem
Trillium Corporation	T/TrilliumCorporation
Triodos Bank	T/TriodosBank
Triple Canopy	T/TripleCanopy
Triton Energy (part of Amerada Hess)	T/TritonEnergypartofAmeradaHess
Triumph International	T/TriumphInternational
Triveni Sugar	T/TriveniSugar
Tropical Farm Management	T/TropicalFarmManagement
Tropicana (part of PepsiCo)	T/TropicanapartofPepsiCo
Tsinghua Tongfang	T/TsinghuaTongfang
Tsogo Sun (joint venture Tsogo Investments & SABMiller)	T/TsogoSunjointventureTsogoInvestmentsSABMiller
tt Timber Group	T/ttTimberGroup
Tucson Electric Power (part of Unisource)	T/TucsonElectricPowerpartofUnisource
TUI	T/TUI
Tullow Oil	T/TullowOil
Tully Construction	T/TullyConstruction
Tully's Coffee	T/TullysCoffee
Turbomeca (part of Snecma)	T/TurbomecapartofSnecma
Turkcell	T/Turkcell
Turkish Petroleum (TPAO)	T/TurkishPetroleumTPAO
Turner Broadcasting (part of Time Warner)	T/TurnerBroadcastingpartofTimeWarner
Turner Construction	T/TurnerConstruction
TVI (Toronto Ventures Incorporated) Pacific	T/TVITorontoVenturesIncorporatedPacific
TVS	T/TVS
Tweezerman	T/Tweezerman
Twentieth Century Fox (see 20th Century Fox)	T/TwentiethCenturyFoxsee20thCenturyFox
Twinings (part of Associated British Foods)	T/TwiningspartofAssociatedBritishFoods
Twins Enterprise	T/TwinsEnterprise
TXU	T/TXU
Tyco	T/Tyco
Tyson	T/Tyson
UAL (see United Airlines)	U/UALseeUnitedAirlines
UBS	U/UBS
UGI Utilities	U/UGIUtilities
Ukrspetsexport	U/Ukrspetsexport
ULBA	U/ULBA
Umbro	U/Umbro
Umeme	U/Umeme
Umgeni Water	U/UmgeniWater
Umicore	U/Umicore
UmweltBank	U/UmweltBank
Unaxis	U/Unaxis
Under Armour	U/UnderArmour
Unibail	U/Unibail
Unibanco (União de Bancos Brasileiros)	U/UnibancoUniodeBancosBrasileiros
Unicredito Italiano	U/UnicreditoItaliano
Unidad Editorial	U/UnidadEditorial
Uniden	U/Uniden
Unifrutti	U/Unifrutti
Uniland	U/Uniland
Unilever	U/Unilever
Unimarc	U/Unimarc
Unimasters Logistics Group	U/UnimastersLogisticsGroup
Union Bank of California	U/UnionBankofCalifornia
Union Carbide (part of Dow)	U/UnionCarbidepartofDow
Union Coffee Roasters	U/UnionCoffeeRoasters
Unión de Cervecerías Peruanas Backus y Johnston SAA (parte de SABMiller)	U/UnindeCervecerasPeruanasBackusyJohnstonSAApartedeSABMiller
Unión Fenosa	U/UninFenosa
Union Pacific	U/UnionPacific
Unisource	U/Unisource
Unisys	U/Unisys
United Airlines	U/UnitedAirlines
United Biscuits	U/UnitedBiscuits
United Business Media	U/UnitedBusinessMedia
United States Enrichment [part of USEC]	U/UnitedStatesEnrichmentpartofUSEC
United States Steel	U/UnitedStatesSteel
United Technologies	U/UnitedTechnologies
United Utilities	U/UnitedUtilities
United Water (part of Suez)	U/UnitedWaterpartofSuez
Unity Resources Group	U/UnityResourcesGroup
Unity Trust Bank	U/UnityTrustBank
Universal Corporation	U/UniversalCorporation
Universal Corporation (Kenya)	U/UniversalCorporationKenya
Universal Forestry	U/UniversalForestry
Univision	U/Univision
Unocal (part of Chevron)	U/UnocalpartofChevron
Unomedical	U/Unomedical
UnumProvident	U/UnumProvident
UPM	U/UPM
UPS	U/UPS
UralSib	U/UralSib
Urban Outfitters	U/UrbanOutfitters
URS	U/URS
US Airways	U/USAirways
US Bancorp	U/USBancorp
USAA	U/USAA
USEC	U/USEC
UTI Bank	U/UTIBank
V&S Group	V/VSGroup
VA Tech Hydro (part of Andritz)	V/VATechHydropartofAndritz
Vaaldiam Resources	V/VaaldiamResources
Vacsera	V/Vacsera
Vail Resorts	V/VailResorts
Valeo	V/Valeo
Valero Energy	V/ValeroEnergy
Van Cleef & Arpels (part of Richemont)	V/VanCleefArpelspartofRichemont
Van de Stadt	V/VandeStadt
Van Rees	V/VanRees
VanCity	V/VanCity
Vanco Energy	V/VancoEnergy
Vanguard	V/Vanguard
Vanguard Car Rental	V/VanguardCarRental
Vanke	V/Vanke
Varig (Viação Aérea Rio-Grandense)	V/VarigViaoAreaRio-Grandense
Vasto Legno	V/VastoLegno
Vattenfall	V/Vattenfall
VaxIntel	V/VaxIntel
VEBA Broumov	V/VEBABroumov
Vector Capital	V/VectorCapital
Vedanta Resources	V/VedantaResources
VediorBis (part of Vedior)	V/VediorBispartofVedior
Veidekke	V/Veidekke
Veillon	V/Veillon
Vendex KBB (see Royal Vendex KBB)	V/VendexKBBseeRoyalVendexKBB
Venoco	V/Venoco
Ventria Biosciences	V/VentriaBiosciences
Veolia Environnement (formerly Vivendi)	V/VeoliaEnvironnementformerlyVivendi
Veracel (joint venture Aracruz Celulose & Stora Enso)	V/VeraceljointventureAracruzCeluloseStoraEnso
Verisign	V/Verisign
Verizon	V/Verizon
Vestas Wind Systems	V/VestasWindSystems
Vestel	V/Vestel
Vestergaard Frandsen	V/VestergaardFrandsen
Vetco Gray (part of Vetco International)	V/VetcoGraypartofVetcoInternational
Vetco International	V/VetcoInternational
VF Corp	V/VFCorp
Viacom	V/Viacom
Viajes Mogador	V/ViajesMogador
Vianova	V/Vianova
Vicente Trapani	V/VicenteTrapani
Vickers Defence (part of Alvis Vickers)	V/VickersDefencepartofAlvisVickers
Victor Bout	V/VictorBout
Victoria's Secret (part of Limited Brands)	V/VictoriasSecretpartofLimitedBrands
Videocon	V/Videocon
Vietnam Airlines	V/VietnamAirlines
Vijayadeep Laboratories	V/VijayadeepLaboratories
Villacero	V/Villacero
Vinci	V/Vinci
Vinnell (part of Northrop Grumman)	V/VinnellpartofNorthropGrumman
Vintage Petroleum	V/VintagePetroleum
Vion (part of Sovion)	V/VionpartofSovion
Virax Holdings	V/ViraxHoldings
Virgin Atlantic (joint venture Virgin Group & Singapore Airlines)	V/VirginAtlanticjointventureVirginGroupSingaporeAirlines
Virgin Blue (part of Virgin Group)	V/VirginBluepartofVirginGroup
Virgin Group	V/VirginGroup
Virgin Mobile	V/VirginMobile
Virgin Trains (part of Virgin Group)	V/VirginTrainspartofVirginGroup
Visa Group	V/VisaGroup
Visa International	V/VisaInternational
Visa Steel (part of Visa Group)	V/VisaSteelpartofVisaGroup
Visteon	V/Visteon
Visy	V/Visy
Vitinka	V/Vitinka
Vivendi (see Veolia Environnement & Vivendi Universal)	V/VivendiseeVeoliaEnvironnementVivendiUniversal
Vivendi Universal	V/VivendiUniversal
Vodafone	V/Vodafone
Voestalpine	V/Voestalpine
Voith	V/Voith
Volcafe (part of ED&F Man)	V/VolcafepartofEDFMan
Volkswagen	V/Volkswagen
Volvo Car (part of Ford)	V/VolvoCarpartofFord
Volvo Group	V/VolvoGroup
Vonage	V/Vonage
Voronezhsynthezkauchuk	V/Voronezhsynthezkauchuk
Votorantim	V/Votorantim
Vought Aircraft	V/VoughtAircraft
VTech	V/VTech
W. R. Grace	W/WRGrace
Waagner-Biro	W/Waagner-Biro
Wachovia	W/Wachovia
Wackenhut (part of Group 4 Securicor)	W/WackenhutpartofGroup4Securicor
Waffle House	W/WaffleHouse
Wah Shing Toys	W/WahShingToys
Waitrose (part of John Lewis Partnership)	W/WaitrosepartofJohnLewisPartnership
Wal-Mart	W/Wal-Mart
Wal-Mart de Mexico (Walmex)	W/Wal-MartdeMexicoWalmex
Waldo's Mart	W/WaldosMart
Walgreen	W/Walgreen
Walkers	W/Walkers
Walt Disney	W/WaltDisney
WAMCO Nigeria (part of Friesland Coberco)	W/WAMCONigeriapartofFrieslandCoberco
Wanda Group Share	W/WandaGroupShare
Wanxiang Group	W/WanxiangGroup
Warehouse	W/Warehouse
Warnaco	W/Warnaco
Warner Bros. (part of Time Warner)	W/WarnerBrospartofTimeWarner
Warner-Lambert (part of Pfizer)	W/Warner-LambertpartofPfizer
Washington Group	W/WashingtonGroup
Washington Mutual	W/WashingtonMutual
Waste Management	W/WasteManagement
Water and Sanitation Services South Africa (part of Suez)	W/WaterandSanitationServicesSouthAfricapartofSuez
Watercare Services	W/WatercareServices
Weatherford International	W/WeatherfordInternational
Websense	W/Websense
Weda Bay Minerals	W/WedaBayMinerals
Weinberg Group	W/WeinbergGroup
Weleda	W/Weleda
Wellcome (part of Jardine Matheson)	W/WellcomepartofJardineMatheson
Wellpoint	W/Wellpoint
Wells Fargo	W/WellsFargo
Wendy's	W/Wendys
Wessex Water	W/WessexWater
West Africa Milk Company (see WAMCO Nigeria)	W/WestAfricaMilkCompanyseeWAMCONigeria
West Bromwich Building Society	W/WestBromwichBuildingSociety
West Coast Paper Mills	W/WestCoastPaperMills
West LB	W/WestLB
Western Areas	W/WesternAreas
Western Mining	W/WesternMining
Western Seed Company	W/WesternSeedCompany
Western Union (part of First Data)	W/WesternUnionpartofFirstData
Westfield	W/Westfield
Westinghouse	W/Westinghouse
Westpac	W/Westpac
Westpoint Stevens	W/WestpointStevens
Weyerhaeuser	W/Weyerhaeuser
WH Smith	W/WHSmith
Wharf Holdings	W/WharfHoldings
Wheaton River Minerals (part of GoldCorp)	W/WheatonRiverMineralspartofGoldCorp
Whirlpool	W/Whirlpool
Whitbread	W/Whitbread
White Lodging Services	W/WhiteLodgingServices
White Martins Gases Industriais (part of Praxair)	W/WhiteMartinsGasesIndustriaispartofPraxair
Whitehall Jewellers	W/WhitehallJewellers
WhiteWave Foods (part of Dean Foods)	W/WhiteWaveFoodspartofDeanFoods
Whole Foods Market	W/WholeFoodsMarket
Wijma	W/Wijma
Wild Oats	W/WildOats
Wilkinson Hardware	W/WilkinsonHardware
William Hill	W/WilliamHill
Williams Companies	W/WilliamsCompanies
Williams Sonoma	W/WilliamsSonoma
Williamson Magor	W/WilliamsonMagor
Willis	W/Willis
Wilmar	W/Wilmar
Windstar Cruises (part of Carnival)	W/WindstarCruisespartofCarnival
Wing Tai Holdings	W/WingTaiHoldings
Winn-Dixie	W/Winn-Dixie
Winsome Group	W/WinsomeGroup
Wintershall	W/Wintershall
Wipro	W/Wipro
Wisekey	W/Wisekey
WMC Resources	W/WMCResources
WNS	W/WNS
Wockhardt	W/Wockhardt
Wolseley	W/Wolseley
Wolters Kluwer	W/WoltersKluwer
Wolverine World Wide	W/WolverineWorldWide
Woolrich	W/Woolrich
Woolworths Group	W/WoolworthsGroup
Woolworths Holdings	W/WoolworthsHoldings
Woolworths Limited	W/WoolworthsLimited
Woongjin Coway	W/WoongjinCoway
Working Assets	W/WorkingAssets
Workwear Lanka	W/WorkwearLanka
World's Finest Chocolate	W/WorldsFinestChocolate
WorldCom (now MCI)	W/WorldComnowMCI
Worldspan	W/Worldspan
WorleyParsons	W/WorleyParsons
WPP	W/WPP
WPS Resources	W/WPSResources
WTK	W/WTK
Wyeth	W/Wyeth
Wyndham	W/Wyndham
Xansa	X/Xansa
Xcel Energy	X/XcelEnergy
Xerox	X/Xerox
Xian Aircraft	X/XianAircraft
Xiaoerbulak Spirits	X/XiaoerbulakSpirits
XinAo	X/XinAo
Xingtai Iron & Steel	X/XingtaiIronSteel
Xinjiang Kangyoumei Grains and Oils	X/XinjiangKangyoumeiGrainsandOils
Xinpeng Industrial Combustion Engineering	X/XinpengIndustrialCombustionEngineering
Xinwen Mining	X/XinwenMining
Xiyang	X/Xiyang
Xstrata	X/Xstrata
XTO Energy	X/XTOEnergy
Ya Hsin Industrial	Y/YaHsinIndustrial
Yahoo!	Y/Yahoo
Yamaha	Y/Yamaha
Yamana Gold	Y/YamanaGold
Yancheng Fuyuan Chemical	Y/YanchengFuyuanChemical
Yangon Airways	Y/YangonAirways
Yanzhou Coal	Y/YanzhouCoal
Yaoyou Pharmaceutical (part of Fosun)	Y/YaoyouPharmaceuticalpartofFosun
Yazaki	Y/Yazaki
Yell Group	Y/YellGroup
Yes Bank	Y/YesBank
Yida Group	Y/YidaGroup
Yilmazlar	Y/Yilmazlar
Yingtong Group	Y/YingtongGroup
Yizheng Shuanghuan Piston Ring (CYPR)	Y/YizhengShuanghuanPistonRingCYPR
Yoojin Engineering	Y/YoojinEngineering
Yorkshire Water	Y/YorkshireWater
YouTube (part of Google)	Y/YouTubepartofGoogle
Yudean (see Guangdong Yudean Group)	Y/YudeanseeGuangdongYudeanGroup
Yue Wing Cheong	Y/YueWingCheong
Yue Yuen	Y/YueYuen
Yuhan-Kimberly (joint venture Yuhan & Kimberly-Clark)	Y/Yuhan-KimberlyjointventureYuhanKimberly-Clark
Yukon Nevada Gold	Y/YukonNevadaGold
Yukos	Y/Yukos
YUM!	Y/YUM
Yunnan Huaneng Lancang River Hydropower (part of China Huaneng)	Y/YunnanHuanengLancangRiverHydropowerpartofChinaHuaneng
"Yunnan Joint Power Development (joint venture Yunnan Huaneng Lancang River Hydropower, Yunnan Power Grid, YMEC)"	Y/YunnanJointPowerDevelopmentjointventureYunnanHuanengLancangRiverHydropowerYunnanPowerGridYMEC
Yunnan Machinery & Equipment Import & Export (YMEC)	Y/YunnanMachineryEquipmentImportExportYMEC
Yunnan Power Grid (part of China Southern Power Grid)	Y/YunnanPowerGridpartofChinaSouthernPowerGrid
Zale	Z/Zale
Zambia Copper Investments	Z/ZambiaCopperInvestments
Zambia-China Mulungushi Textiles (joint venture Qingdao Textile & Zambia Ministry of Defence)	Z/Zambia-ChinaMulungushiTextilesjointventureQingdaoTextileZambiaMinistryofDefence
Zara (part of Inditex)	Z/ZarapartofInditex
Zee	Z/Zee
Zephyr-Graf-X	Z/Zephyr-Graf-X
ZMQ Software Systems	Z/ZMQSoftwareSystems
Zoglobek	Z/Zoglobek
ZTE	Z/ZTE
Zunyi Titanium	Z/ZunyiTitanium
Zurich	Z/Zurich
Zydus Cadila	Z/ZydusCadila
24 Hour Fitness	Other/24HourFitness
20th Century Fox (part of News Corp)	Other/20thCenturyFoxpartofNewsCorp
3 Mobile (part of Hutchison Whampoa)	Other/3MobilepartofHutchisonWhampoa
180 Connect	Other/180Connect
3 Suisses	Other/3Suisses
3M	Other/3M
3i	Other/3i
7 UP (see Seven Up)	Other/7UPseeSevenUp
